b	å®¶
p	æƒ³
m	äº›
f	ä¸­
d	ä¹Ÿ
t	å»
n	çœ‹
l	ä»–
g	ä¹‹
k	æ¥
h	ç”Ÿ
j	å°±
q	æœ‰
x	å¥½
z	ç¬¬
c	è¿‡
s	éƒ½
r	ä¼š
v	å¯¹
w	è¿™
y	èƒ½
ba	å…« 8 å…«
bo	åˆ†
be	å…¬
bi	å¿…
bu	ä¸æ˜¯
b;	å®Œ
b,	å®
b.	æœ¬ B b
b/	å®š
pa	æœ¨
po	æ ¡
pe	æœº
pi	çš®
pu	ç›¸
p;	æ ·
p.	ğŸˆšï¸ P p
ma	é©¬ A a
mo	æœ« O o
me	ä¹ˆ E e
mi	æ²¡æœ‰ I i
mu	ç›® U u
m;	å…
m,	ï¼ˆ
m.	ï¼‰ M m
m/	æ°´
fa	å§
fo	å£
fe	é
fi	åƒ
fu	å¤«
f;	å
f,	æ–¹
f.	è·Ÿ F f
f/	å—¯
da	å¤§
do	å¾—
de	ç€
di	è€Œ
du	ä½†æ˜¯
d;	å‰
d,	ä¸º
d.	å¾ˆ D d
d/	ä¸œ
ta	å®ƒ
to	å‡ 
te	ä»–ä»¬
ti	åœ°
tu	åœŸ
t;	ç”°
t,	ï¼›
t.	ï¼š T t
t/	åŒ
na	æ‰‹
no	å›½
ne	å†…
ni	å››
n;	å¹´
n,	ç½‘
n.	æ‰¾ N n
n/	ç”¨
la	å…­ 6 å…­
lo	è€
le	åˆ«
li	ä½ 
lu	åš
l;	å­
l,	æ„
l.	é‚£ L l
l/	å¦ 0 é›¶
ga	å
go	æ‰€
ge	ä¸ª
gi	è´¨
gu	åº¦
g;	å¹²
g,	å¹¿
g.	é—® G g
g/	å…±
ka	å¡
ko	åˆ°
ke	ä¸€
ki	å¼€
ku	æ²¡
k;	å¤©
k,	ä¸¤
k.	äº‹ K k
k/	å¯ä»¥
ha	å±±
ho	ç«
he	å›
hi	è‡ª
hu	è¿˜æ˜¯
h;	ç‚¹
h,	ä¸š
h.	å…ˆ H h
h/	ç§
ja	ç”² 9 ä¹
jo	è¯´
je	å¤š
ji	ä»¥
ju	å¥
j;	è§
j,	å°±æ˜¯
j.	é‡‘ J j
j/	å‘
qa	å³
qo	å·¦
qe	åˆ‡
qi	ä¸ƒ 7 ä¸ƒ
qu	æ›²
q;	å…¨
q,	ï¼Ÿ
q.	ï¼ Q q
q/	å‹
xa	ä¸‹
xo	å°
xi	è¥¿
xu	è¦
x;	å¥¹
x,	å‘
x.	ç°åœ¨ X x
x/	å…„
za	è¿™æ ·
zo	æ—©
ze	çŸ¥é“
zi	åª
zu	è‡ªå·±
z;	è¿™ä¸ª
z,	é•¿
z.	çœŸ Z z
z/	ç­‰
ca	æ„Ÿ
co	åˆ€
ci	æ‰
cu	å‡º
c;	åŸ
c,	æœŸ
c.	å…¶ C c
c/	æˆ
sa	æ‰€ä»¥
so	å„¿
se	å­¦
si	å 4 å››
su	ä»€ä¹ˆ
s;	ä¸‰ 3 ä¸‰
s,	ä¸Š
s.	å½“ S s
s/	æ€§
ra	è‚‰
ro	å¦‚æœ
re	æœ€
ri	æ—¥
ru	æ—¶
r;	ç”µ
r,	ç„¶å
r.	äºº R r
r/	ä»
va	è¿›
vo	åˆ
ve	ç»™
vi	äºŒ 2 äºŒ
vu	åŠ¨
v;	ä¸“
v,	â€œ
v.	â€ V v
v/	ç»
wa	æˆ‘ä»¬
wo	è¨€
we	æœª
wi	ç†
wu	æ—  5 äº”
w;	å˜
w,	ç‹
w.	æ–‡ W w
w/	é«˜
ya	ç”±
yo	ä¸€ä¸ª
ye	æœˆ
yi	å·² 1 ä¸€
yu	ä¸
y;	å› ä¸º
y.	ğŸˆšï¸ Y y
bb	ç©º
bm	ç–¤
bf	å®«
bd	å†›
bt	ç–¯
bn	å®œ
bl	å­—
bk	ç—…
bh	èµ›
bj	å¯Ÿ
bq	å® 
bx	æ¡ˆ
bz	ç–‘
bc	å®½
bs	å®³
br	å¯“
bv	å®—
bw	å®¢
by	çˆ¸
pb	æ¾
pp	æ¥š
pm	æœ´
pd	æ¥¼
pt	æ¡‚
pn	æ
pl	æ
pg	è¿°
pk	æ§½
ph	æ¡ƒ
pj	æ¦‚
px	æ 
pz	æ¢…
pc	æ¨¡
ps	æ„
pr	æŸ¥
pv	æ ‡
pw	æ ¼
py	æ¡¥
mb	ç
mm	æ­¥
mf	é©¶
md	éª‘
mt	é»‘
ml	å‹‰
mg	éª—
mk	é©±
mh	ç¡
mj	éªŒ
mz	ç¬
mc	é¾„
ms	ç½®
mv	åŒ—
mw	é©»
my	å¹½
fb	å“”
fm	è·¯
ff	å“
fd	è¾ˆ
ft	å–‚
fn	å‘˜
fl	å“ª
fg	å¬
fk	å·
fh	å‘¼
fj	å“ˆ
fq	å‘€
fx	åµ
fz	æ—
fc	å–Š
fs	è´µ
fr	å•¥
fv	å•Š
fw	å’¯
fy	è›‡
db	èµ„
dp	æ•°
dm	è¿˜
df	æ€»
dd	é“
dt	å¾…
dn	é¢
dl	å‡†
dg	æ€
dk	å…³
dh	å¾®
dj	å‡€
dq	å½»
dx	å¾‹
dz	å¾¡
dc	å‡
ds	è½¬
dr	å•
dv	è¡Œ
dw	ç¾
dy	å¾Œ
tp	æ ½
tm	ç›
tf	è¢
td	å¢
tt	å°
tn	åœ¾
tl	ç”·
tg	å¡˜
tk	åŸŸ
th	èµ«
tj	åŸ‹
tz	èµ·
tc	åŸ
ts	å‡
tr	ç•Œ
tv	å›
tw	ç•¥
ty	å´
nb	æŒ‡
np	å›°
nm	æŠŠ
nf	æ“
nd	å› 
nt	æŒ
nn	æ‹¥
nl	æ¥
ng	æ®
nk	æ‰“
nh	æ‹
nj	æ¢
nq	æ‹”
nx	æŠ„
nz	æˆ
nc	å›¢
ns	æ±‚
nr	æ
nv	æ‹©
nw	å›¾
ny	åˆš
lb	å
lm	ä¿®
lf	ä¿
ld	ä¹¦
lt	ä½³
ln	å­©
ll	ä½
lg	é€š
lk	éƒ¨
lh	åŠ 
lj	ä¼¼
lq	ä¼˜
lx	ä½
lz	ä½œ
lc	é¢œ
ls	å€¼
lr	ä½†
lv	ä¹°
lw	ä½
ly	æ•ˆ
gb	å±
gp	éº»
gm	çˆ¬
gf	å¼º
gd	å¼¹
gt	é‹
gn	é—´
gl	å±€
gg	æˆ¿
gk	å±‹
gh	åº—
gj	åºŸ
gq	è´¹
gx	è¿‘
gc	å¸­
gs	åº”
gr	åˆ·
gv	å±‚
gw	å¼¦
gy	é»„
kb	æ·±
kp	å©†
km	æ”¿
kf	å¯
kd	å¹³
kt	æ³•
kn	å†
kl	æ±¤
kg	æ´¾
kk	æ²³
kh	æ´»
kj	äº’
kq	é­
kx	å¼
kz	æµ·
kc	æ»¡
ks	å¸¦
kr	æ›´
kv	æ¸…
kw	æµ
ky	åŒº
hb	å´‡
hp	ç¨‹
hm	æ¯
hf	æˆ˜
hd	ä¹
ht	é€‰
hn	ç‰©
hl	æ‚
hg	ä¹
hk	ç¯
hh	è™š
hj	å²
hq	èº«
hx	ç‚’
hz	ç‚¸
hc	å²¸
hs	ç‰‡
hr	é‚€
hv	è¿½
hw	å³°
hy	ç³»
jb	è°
jp	é€”
jm	è‰²
jf	æ‹¿
jd	è¢«
jt	è°“
jn	è°ƒ
jl	æ¯
jg	å¤–
jk	è¯•
jh	è¯
jj	å¤Ÿ
jq	æ—¢
jx	è¯­
jz	è®¸
jc	è§£
js	è¯»
jr	è¯¾
jv	ç„¶
jw	è¯¥
jy	è¯¶
qb	é¾™
qm	å­˜
qf	é’Ÿ
qd	é“¾
qt	é“…
qn	é’¢
ql	é•œ
qg	é”™
qk	é“º
qh	é“
qj	å°¤
qq	éƒ
qx	é”®
qs	é”€
qr	é“ƒ
qv	é’±
qw	é”‹
qy	é›„
xb	å«
xm	è‚ƒ
xf	å¨±
xd	å«Œ
xt	å¨ƒ
xn	å»º
xl	äº”
xg	å¨˜
xk	åŠŸ
xh	ç¾¤
xj	è¾©
xx	å©š
xc	åª’
xs	å§‘
xr	å·«
xv	é…
xw	å©·
xy	å§‹
zb	çˆ±
zp	å½©
zm	ç®—
zf	å–œ
zd	çŸ¥
zl	ç¬¦
zg	ç®€
zk	ç­–
zh	ç¼º
zj	ç­”
zq	ç¬¼
zx	ç­‘
zz	é¥
zc	è²Œ
zs	èˆ
zr	åˆ¶
zv	æ¬¾
zy	ç¬”
cb	è¥
cp	å¢
cm	è
cf	å’¸
cd	é¡º
ct	å‹
cn	è‹±
cl	å†
cg	èŠ
ck	ä¸–
ch	æ„¿
cj	è­¦
cq	è
cx	å¨
cz	èœ
cc	è—
cs	åŸº
cr	å¹•
cv	æŸ
cw	è’
cy	è‘£
sb	ç´¢
sp	è€—
sm	è‰³
sf	å¸¸
sd	æ€€
st	æ€¯
sn	ç›´
sl	å¿«
sg	æƒœ
sk	æ°‘
sh	æ€•
sj	æƒ¯
sq	è€ƒ
sx	å”
sz	æœ
sc	æ‡‚
ss	æ„¤
sr	æ…¢
sv	æƒ…
sw	å¿™
sy	æƒ¨
rb	æ™•
rp	é¢—
rm	æ›¼
rd	ä¼
rn	é‡
rl	é¢†
rg	æš´
rk	é‡
rh	æ˜Ÿ
rj	å½±
rz	é¢˜
rc	ç…§
rs	æ˜“
rr	ä¼—
rv	æ™´
rw	ç¦½
ry	ç›Ÿ
vb	é™¢
vm	æ­¦
vd	é˜µ
vt	é™µ
vn	è´£
vl	éš¾
vk	ç»“
vh	è¡¨
vj	é™¤
vq	éš
vx	é¿
vz	ä¸´
vc	æ€¼
vs	è¿œ
vr	é˜¶
vv	é™…
vw	é™
vy	è¿
wb	äº®
wp	ç³
wm	å¤„
wf	è¡·
wd	ç­
wt	æƒ«
wn	çƒ
wl	åŠ¡
wg	ç‘•
wh	è¡£
wj	æœ›
wz	ç‘¶
wc	çª
ws	é€¢
wr	ç
wv	ç©
ww	ç´
wy	ç¦»
yb	è„‚
yp	éœœ
ym	è‚¥
yf	éœ²
yd	æœ
yt	è„š
yl	å¹¼
yg	åˆ’
yk	è…»
yh	èƒœ
yj	è„¸
yq	å¸Œ
yx	è…°
yz	è…¹
yc	éœ‡
ys	é‡
yr	é›¶
yw	è„‘
yy	èƒ
bba	ç©´
bbe	ç—º
bbi	æ¯” å®“ ç–•
bpa	å®‹
bpi	ç–²
bfe	ç—±
bd;	ç––
bto	å†— å®‚
btu	å†¤ å¯ƒ
bt/	ç—Œ
bno	é¹
bni	ç–“
bla	å®
bgu	å®¹
bg.	ç—•
bg/	å®†
bha	ç– å†š
bho	ç¾ ç–¢
bhe	ç—
bja	ç–š
bju	ç—€
bj.	é‡¡
bq;	ç—Š å®Š
bq/	è‚
bxa	ç–œ
bxo	å®‰
bxe	ç–Ÿ
bx.	å®°
bx/	å…Œ
bzi	ç–»
bzu	å®š
bz.	å¯˜ ç˜¨
bco	åˆ†
bc.	å®ˆ ç–›
bso	å†˜ å°£
bsu	ç–«
bs.	å®¡
bri	æ—¨
bvi	å®˜ éƒ« é‚²
bw.	æ•
bya	å®™ å®¦
byo	å…¬ å®
byi	çˆ¶
byu	å†™
pba	æœ³
pbo	æ´
pbe	æ¤‘
pbi	æœ¼ æŸ²
ppa	æ—
ppi	æŸ€
pma	æ© æ«
pmo	æº
pmu	ç›¸
pm;	æ¢š
pfo	æ
pfe	æ£‘
pfu	æ
pf;	æ¿ æ‹
pf,	æ‹
pda	æ•
pd/	æ ‹
pta	æŸ
pto	æœº
ptu	æœ
pt/	æ¡
pna	æ½
pne	æ˜
pla	æº
plo	æ ³
ple	æœ°
pli	æ§…
plu	æ¨š
pl/	æŸº
pga	æŸ§
pgi	æœ¯ æœ®
pg;	æ† çš¯
pg.	æ ¹
pg/	æ› æ ±
pki	æ…
pha	æ£
pja	æ¡• æŸ™ æ¦
pjo	æ¡·
pje	æœ­
pji	æ
pju	æ¸
pj;	æ§
pj/	æ¤‹
pqo	æ°
pq;	æ “ æ¤
pxi	æ –
px,	æ©¡
px.	æ¢“
px/	æŸ·
pzi	æ³
pzu	æ ª
pz,	æ– æ¨
pz.	æ§™
pco	æœ·
pci	æ æŸ
pcu	æŸ®
pc;	æŠ
pc.	æ‘
pso	æ“
psu	æœ» æ¸
ps;	æ‰
ps.	æŸ›
pri	æ³
pr.	æœ² æ’
pvo	æƒ
pv,	æŠ
pw,	æ‰
pw.	æš
pya	æŸš æ •
pyo	æ–
pye	æ‚
mba	è²
mbo	æ¬ 
mbe	å‘ ç¥
mbi	æ­¤ åŒ•
mma	æ­¢
mmo	çœœ
mmi	éº¦
mmu	çœ‰
mm;	çŒ
mm.	çš¿
mfe	ç½ª ğ¬´‚
mfu	éº¸
mf;	å‡¡ çœ…
mf,	çœ†
mda	é©®
mdo	å½³
mdi	æ­¹
mta	é©¼
mto	æ¡ å‡£
mtu	å…”
mt/	çœ®
mno	é¸Ÿ é¿º
mni	ä¹ƒ
mla	å¿ƒ
mle	ä¹™
mli	é¬²
mlu	é¹¿
ml.	ä»‘
mga	ç“œ ç½›
mgo	å°¸
mge	é©
mgi	åœ
mgu	è°·
mg;	ç›°
mg.	çœ¼ è‰®
mg/	å¼“
mja	ä¹… è‡¼
mjo	è§’
mje	å·´
mji	å·±
mju	é©¹ çœ—
mj;	ğª¾¢
mj/	äº¬
mqa	ä¸˜
mqo	é¦¬
mqi	æ°”
mq;	çŠ¬ ç‹Š
mq/	è‚¯
mxo	å¥³
mxi	ä¹ 
mx,	è±¡
mx.	è¾› éª
mx/	çœ–
mzo	å£«
mzu	æœ± æ­¨
mz,	ä¸ˆ
mz.	ç‹
mci	æ–¥
mcu	é½¿
mc;	å· é©¯
mc,	å‚
mc.	å¯¸
mso	è¦‹ å‹º
msi	æ°´ å·³ æ°º
msu	æ®³
ms.	ç”³ çœ’
mro	å·¾
mri	æ—§ é©²
mr.	åˆƒ ç½–
mvo	é©­
mwa	ç“¦
mwo	è©ˆ
mwe	çœ›
mwu	ä¹Œ
mw;	ä¸¸
mya	è‡£
myo	å¤­ å¹º
mye	æ›° çœ€
myu	é›¨
fba	å­
fbo	å¹
fbe	å•¤
fbi	å± å’‡
fb.	å‘ 
fpa	å‘† æ£
fma	å—
fme	ä¸­
fmi	å”›
ffo	å• å…
ffe	å•¡
ffu	å‘‹
fda	å¥œ
fdo	å‰•
fd;	å©
fta	å’œ
fto	å½
ftu	å
ft/	å“ƒ
fno	é¸£
fne	å‘ å‘™
fn;	å“–
fla	æ‚² å£
flo	å’¾
fli	å—
fga	å‘±
fgu	å”‚
fg.	å“
fg/	å“„
fka	å’”
fke	éŸ­
fki	å’
fho	å™
fja	å‘·
fjo	å”ƒ
fju	å‘´
fj;	è§„
fj.	å”«
fq;	å  çŒ†
fq/	è‚™
fxa	å“
fxo	å©“
fxi	å“‚
fx,	å“
fx/	å‘ª
fzi	è¿” å‘®
fzu	è¶³ å’®
fz.	å—”
fco	å¨ å§
fcu	å’„
fc.	å‹
fsi	å¶
fsu	å« åº
fs.	å‘»
fro	åŠ
fvo	å¹
fvi	é‚¡ é‚
fwa	å’“ ç“¬
fwo	å”
fwe	å‘³
fwu	å‘œ å‘’
fw,	å‘ˆ
fw.	æ”¾ å‘š
fyo	è™« å†
fyi	å²
dbo	æ¬¡
dbi	æ­»
dpa	ç±³
dpi	å½¼
dma	å†¯
dme	ä¸« ä¸¬
dm;	å‡‚
dfo	çŸ³ å¤»
dfe	å¾˜
dfu	é¾¹
df,	å½·
dda	å¤¶
ddo	åˆ—
dd;	å…¯
dd/	å†»
dtu	åœ¶
dt;	å¥‹
dna	åŠ
dno	é¸«
dgi	å¤ª åª
dg.	å¾ˆ
dke	å«
dki	å¹¶
dhe	å¾Š é£
dje	ä¹Ÿ
dj.	å‡
dj/	å‡‰
dqo	å¤°
dxo	å¤µ
dxe	å½’
dxi	å¾†
dx/	å†µ å…‘
dzi	è¾¾
dzu	æ®Š
dz,	å¥—
dc;	å¤¼
dc.	å¤º
dso	å½´
dsi	è½¦ å¤²
dsu	å½¹ æ®
ds;	å…°
dro	å¸…
dri	ç™¾
dvi	å†­ å¤³
dw,	å½º
dyo	åº æ®€
tbo	å
tbe	åŸ¤
tpa	æœµ å‡©
tpi	å¡
tma	å€ å‡ª
tfu	ç•‰
tf;	å‚ ç•ˆ
tf,	åŠ
tdi	å¤™
tta	å¨
ttu	åœ­ å 
tt;	ç••
tt/	åŒ
tne	å‡·
tn/	ç•€
tla	æ€
tli	å¡¥
tlu	å¡¶
tl.	ğ«­¢
tga	å¬ ç•–
tgi	åœ¡
tg,	åœ¹
tg.	å 
tg/	ç•° å¬
tha	åœ¸
tho	èµ¤ ç»
tja	ç•‚
tjo	åŸ†
tje	åœ 
tji	åœ®
tju	å¸
tqa	åµ
tq;	ç•
tq/	èƒƒ
txa	åœ·
tx,	å§
tx.	å¶
tzi	é€¸ è¿± è¿µ
tzu	èµ°
tz.	å¡«
tci	å¼
tc;	åœ³ ç”½
tc.	å¯º
tso	åœ¥ åœ´
tsi	åœ¯
tsu	å„
ts,	åœµ
ts.	å¤
tro	å‡§
tvo	å‡¤
twu	å
tw.	ç•‹ å†
tyo	å»
tyi	é£
nba	æ‰’
nbo	æ‰» æ¬®
nbe	æ­
npa	æœ¶ æ¢Ÿ æ­
npi	æŠ«
nma	æ‰¯
nmo	æŠ¹
nme	å±®
nmu	çœ‹
nm;	æŒ½
nm.	ç›
nfo	æ‰£ å†‹
nfe	æ’
nfu	æ‰¶
nf;	æ‰³
nda	å¤®
nta	é¸µ æ‹•
nto	å‡« é³¬
ntu	å†‰ æ‰—
nt/	æŒ
nna	ç”¨ æŠ™
nne	å‡» æŠ
nni	æ‰”
nla	æŠ‹
nli	æ¹
nlu	æ‘
nl.	æŠ¡
nl/	æ‹
ngi	åŠ
ng;	æ‰
ng,	æ‰©
ng.	æ‹«
ng/	æ‹±
nka	æ‹¤
nke	å›—
nha	å³¶ å²›
nja	æŠ¼
njo	æ”
nje	æ‰
nju	æ‹˜
nj.	æ¦
nj/	æ 
nqa	æ‹
nqo	é³¥
nq;	æ‹´
nxo	å°•
nxe	æ‰«
nxi	æ‹ª
nx/	æ‹€
nzi	é€† æŠ§ è¾¸
nz,	æ‰™
nz.	æ·
nco	å†Š
nci	æ‹†
ncu	æ‹™
nso	æ‰š
nsi	å›˜
nsu	æŠ•
ns;	ä¸”
ns,	å††
ns.	æŠ»
nr.	è´ æ‰¨
nvo	å¤ƒ
nvi	å†ƒ å†„
nv,	æŠ‘
nwo	ä¸¹
nwe	æŠº
nwu	æŠš
nw;	æ‰§
nw,	æŠ‚
nya	æŠ½ æŒ‹
nyo	æ‰• æ‰·
nye	æœ” æŠ‡ æŠˆ
nyi	å†ˆ ç½“
lba	ä»ˆ
lbe	ä¿¾
lbi	åŒ– ä½– éº€
lb.	ä½“
lpa	ä¼‘
lpi	ä½Š
lme	äº† ä»«
lm;	ä¿›
lfo	å¢
lfe	ä¿³
lfu	ä¼•
lf;	ä»®
lf,	ä»¿
lda	å¤¬
ldo	åˆ«
ld;	é£
lta	ä½—
lto	éº‚ ä»‰
ltu	ä¸‘ å¡µ
lt;	ç•™ ä½ƒ ä¹ª
lt/	ä¾—
lna	å­ å­‘ ä¸®
lno	é¹
lni	ä»
lla	ä¼ˆ
llo	ä½¬
lle	äº¿
ll.	ä¼¦
lge	é·
lgi	å»´ ä¹„ é¾´
lgu	ä¿—
lg;	ä» 
lg.	ä½·
lg/	ä¾›
lka	ä½§
lke	ç«‹ åˆ
lha	ä»™
lho	ä¼™
lhe	åŠ› ä½ª
lje	ä¹œ
lju	ä½ è€ˆ
lj;	ä¼£
lj.	é–
lj/	å€ éº–
lqo	éºƒ
lq;	ä¼ ä½º
lxo	ä¹ ä»¦
lxi	ä¾¡
lx,	åƒ
lx/	å…—
lzo	ä»•
lzi	ä¼¿
lzu	ä¾ ç–‹
lz,	ä»— ä¼¥
lz.	å‚
lc,	äº§
lc.	ä»˜
lso	ä»¢
lsi	ä»€ å‚
lsu	ä¼‡
ls;	ä»¨
ls,	ä»©
ls.	ä¼¸
lri	è€†
lr.	ä»
lvo	ä»…
lvi	ä» ä½€ é„œ
lv,	ä»°
lwa	ä½¤
lwo	ä¿¡ éš¹
lwe	ä½…
lw,	ä»¼
lya	ä¼·
lyo	ä» ä»¸
lye	ä»´
lyi	äº¤
gbo	æ¬² å¼
gbe	åº³ é
gbi	å°¼ åº€
gpa	åºŠ æ˜
gpi	é
gmo	éº
gme	å¼• å¼” åº…
gm;	é”
gfo	å’¼
gfe	å±
gda	åº†
gdo	åˆŠ
gd;	å»
gto	å‡¥
gtu	åº„ å¦ é¯
gt;	å±‡
gna	æ‹²
gno	é¹† é¸¤
gne	é—¨ é¹
gn/	äº£
gla	æ³ å¿œ
glu	å»˜
gga	å¼§
ggo	æˆ·
ggi	å°º
gg;	å¹µ é¬
gg.	è‰¯ é
gg/	æˆ¶ å¼œ è°¼
gke	å¼–
gja	åº˜
gj/	å¼¶
gqo	å¼—
gq/	éª¨
gxa	æ–¤ å
gx.	å±–
gzi	é€€ è¿€ è¿‰ é€§
gz,	å¼ 
gcu	å±ˆ
gso	ç“ é®
gsi	å··
gri	æ˜”
gr.	åº‚ é­
gvi	é‚ é‚— ä¢¼ éƒ¤
gwu	åº‘
gw.	æ”¼
gya	å±Š åº™ å¼«
gyo	å¼˜ åºƒ
gyi	ä¹‰
gyu	å±š
kba	æ±ƒ
kbe	æ¸’
kbi	æ³Œ
kb.	æ³
kpa	æ²
kpi	æ³¢
kma	æ­£ æ²š
kmo	æ²«
kme	ä¸
kmu	æ³ª
km;	æµ¼
kfe	æ¸„
kf;	æ± æ±³
kf,	æ±¸
kda	å¤© æ±
kdo	åˆ‘
kta	æ²±
kto	æ¶¤
ktu	æ±¢
kt;	æ²º
kt/	æ´
kna	äº
kne	ä¸™ æ±­
kn/	äº“
kla	æ²
kli	æ»†
klu	æ¼‰
kl.	æ²¦
kga	æ³’
kgo	æˆ¸
kgu	æµ´
kg;	æ±—
kg.	æ³¿
kg/	æ´ª
kki	æ±§
kha	æ±•
kho	ç­ çƒ
khe	æ´„
kh;	è€³
kja	æ±£
kjo	ä¸‡
kje	åŒš ä¸‚ åŒ¸
kju	æ³ƒ
kj.	æ·¦
kj/	æ¶¼
kqi	æ±½
kqu	æµ€
kq;	æ±± æ´¤
kxo	æ±
kxi	æ´’
kx,	æ½’
kx/	æ³
kzo	è»Š
kzi	è¾·
kzu	æ´™
kz.	æ»‡
kco	è±•
kci	æ³
kcu	æ³
kc;	å… æ±Œ
kso	å…€ æ±‹
ksi	æ± æ±œ
ksu	æ²¡
ks;	å½¢ åŒ
kro	å·¿ å¸€
kri	æ±¨
kr.	æ±„
kvo	æ±‰
kvi	é‚¢
kwe	æ²¬
kwu	ğ£²˜
kw;	æ±
kw,	æ±ª
kw.	æ±·
kya	æ²¹
kyo	æ²ƒ
kye	æ±©
hbo	ç‚Š
hbe	å´¥ ç„·
hbi	è™™
hpa	ç¦¾ ç‚‘
hpi	å²¥
hmu	è‡ª
hm.	è¡€
hfo	å 
hfu	å¤±
hf;	å²… ç‚
hdo	ä¹Š ç²
hd/	å²½
hta	å²® ç‚¨
hto	è™ å‡¢
htu	ç¶
ht;	ç”¶ ç•‘
ht/	å³’ å³ çƒ”
hna	ç‰› ç‰œ
hni	å±·
hn/	å‡ ç·
hla	è™‘
hlo	å³”
hle	ä¹
hli	é¬³
hlu	ç†
hgo	å¢
hge	ç…‚
hgi	å…¥
hgu	å³ª ç„€
hg;	å±½
hg.	å³
hg/	çƒ˜ çƒ¡
hke	ä¸š
hki	å²
hha	ç¿ å±² å±¾ å²€
hho	ç‚ ç‚
hja	å²¬ ç‚ 
hjo	å´…
hje	ä¹¢
hji	å²‚ å±º
hju	å²£
hj;	å²˜
hj.	å´Ÿ å´¯
hqa	å²´ è™—
hqi	ä¹‡
hqu	ğª¨°
hq;	å³‘ çƒ‡
hxe	è™
hx,	å¶‘
hx.	å³·
hx/	å²² ç‚¾
hzo	å“ å£¬
hzi	è¿´ ç‚½ è¾¿
hz.	åµ®
hco	å±¶ ç±
hcu	ç‚ª
hc,	å±µ
hso	ç¼ ç®
hsi	åƒ
hsu	ç‚ˆ
hro	å¸
hri	ç™½
hr.	å±» å²ƒ
hvo	ç”Ÿ
hvi	äº— é‚– é‚©
hv,	å²‡
hwo	è¨”
hw.	ç‚‡
hya	å²« å³€ çƒ¥
hyo	å²†
hye	èˆŸ å²„
hyu	å±¿
jba	é‡Ÿ
jbo	æ¬½ æ¬¨
jbe	éŒ
jbi	é‰
jb.	é‰¢
jpa	ä½™ éˆ¢
jpi	è¯ éˆ¹
jpu	éˆ™
jme	äº‡
jmu	é‰¬
jm;	é‹”
jfo	åˆ é‡¦
jfe	è¯½
jfu	éˆ‡
jf;	é‡© éˆ‘
jf,	è®¿ éˆ
jda	é‡±
jdo	é‡— å‰ 
jd;	å³ è¡¤
jta	é‰ˆ
jto	è®¥ é‡ 
jtu	é‡·
jt;	éˆ¿
jt/	éŠ… ğ«£
jno	é¸­ é¸²
jne	éˆ‰ è®·
jni	é‡¢
jn/	èˆ
jla	å¿Œ éˆŠ
jlo	éŠ 
jle	é‡”
jli	é˜
jlu	é• éº
jl.	è®º
jga	è§š éˆ²
jgi	å¤• ç¤»
jgu	é‹Š
jg;	è®¦ é‡¬
jg.	éŠ€ ğ¬£³
jg/	é‰·
jka	é‰²
jke	é±¼
jki	éˆƒ
jha	è®ª
jho	ç¸ éˆ¥
jja	é‰€ è‡½
jje	é¥£ é‡“
jji	è®°
jju	é‰¤
jj.	é‚
jj/	è°… é„
jqo	é­š
jq;	éŠ“ è¯ 
jxo	å°” å¦€ é‡¥ é‡¹
jxe	åˆ
jx,	éŠ„ éŒ
jx.	é‹… è§ª
jzi	è¯† é‰™
jzu	è¯› éŠ–
jz.	é®
jco	é‡–
jci	è¯‰ é‡®
jcu	è¯ éˆ¯
jc;	è®­ é‡§
jc,	åƒ
jc.	è®¨
jso	å…’ é‡£
jsi	è®¡ é‡ é‡²
jsu	è®¾ è§“ éˆ 
js;	é‡¤
js,	è®©
js.	é‰®
jro	å¸ 
jri	éˆ¤
jr.	è®¤ è‡¾ ä¹† è®± é‡°
jvi	é‡Œ é‚” é‚­ éˆ»
jw;	é‡»
jw.	æ”¹ æ•‚
jya	éˆ¾
jye	éˆ…
jyu	é¼ 
qba	å…µ
qbo	é’¦
qbi	é“‹
qb.	é’µ
qpi	é“
qmi	é¿
qmu	é’¼
qfo	å³
qfu	ğ«“§
qf;	é’£ é’’
qf,	é’«
qdo	é’Š åˆ
qta	é“Š
qtu	é’
qt;	é’¿
qt/	é“œ
qne	é’  å†‡ æ°
qni	æ°–
qla	å¿¥
qlo	é“‘
qle	é’‡
qli	é•‰
ql.	ğ¬¬­
qgi	ä¹“
qg.	é“¶
qg/	ğ«Ÿ¹
qki	é’˜
qha	å²³ æ°™
qho	ç° é’¬
qhe	ä¹’ æ°•
qja	é’¾
qje	å°¢ é’†
qqo	æ°˜
qq;	é“¨
qq/	æœ‰
qxo	é’•
qxi	æ°¥
qx.	é”Œ
qzi	è¿–
qzu	é“¢
qz,	ğ¬¬®
qz.	é•‡
qco	åˆ‡
qc;	é’ æ°š
qso	é’“ å…‚ æ—¡
qsi	é’ˆ
qs;	é’
qs.	æ°  ğ¬¬¹
qro	å¸ƒ
qri	æ°œ
qvo	å‹
qvi	é‚±
qwu	é’¨
qya	é“€
qyo	å·
qye	é’¥
qyi	æ°—
xbe	å©¢
xbi	å¦¼
xpa	æ —
xma	å¦ˆ
xmo	å¦º
xme	è‚€
xm;	å¨©
xfo	å¦‚
xfe	å©”
xfu	å¦‹
xf,	å¦¨
xda	å°–
xd;	å°
xtu	å°˜ å” å©
xt/	å§›
xna	è¿
xne	å¦ 
xni	å¥¶
xn;	å§©
xla	å¿‘
xlo	å§¥
xle	ä¹¤
xgi	å°
xg;	å¥¸
xg/	å¨‚
xke	å·¥ è¥¾
xki	å¦
xha	å¥¾
xho	çµ
xhe	å°‘ å°¹
xja	å¥º
xje	æ° ä¹µ
xji	å¦ƒ
xju	å§
xj/	å©›
xq;	å§¾
xxo	è¦ å¥»
xxe	å¦‡
xxi	ç¾½
xx,	å§ 
xx.	è¾¡
xzo	è¦ƒ
xzi	è¿º é€ˆ
xzu	å§
xz.	å«ƒ
xc.	å¯»
xso	å¦
xs.	å¦½
xro	å¸‡
xvo	å¥´
xvi	é…‰ é‚š
xwo	å¨®
xwe	å¦¹
xwu	å¦©
xya	å¦¯ å§«
xyo	å¦–
zbe	ç®„
zb.	ç¬¨
zpa	é‡‡
zma	ç¬ƒ
zme	å£°
zm.	ç¬½
zfo	å‰
zf;	ç«¼
zda	çŸ¢
zd;	å£­
zto	ç­¿
ztu	ç
zt/	ç­’
zne	ç¬
zla	å¿—
zle	ä¹
zlu	ç°
zga	ç¬Ÿ
zg;	ç«¿
zki	ç¬„
zha	ç¼¶
zja	èˆ€ ç¬š é•¹
zju	ç¬±
zj;	è§… ç¬•
zqu	ç­
zq;	ç­Œ
zxo	å¦¥ å°“
zco	è±¸
zcu	ç¬œ
zc.	å¯½
zsi	åˆ
zs;	é«Ÿ
zvi	ç«º é‚¾
zwa	ç“º
zw;	ç¬‚
zya	ç¬›
zyo	ç¬‘ é•º
cbo	èŠ¡ æ¬ª
cbe	è†
cbi	è‹¾
cb.	è‹¯
cma	èŠ·
cmo	èŒ‰
cmu	è‹œ
cm;	è¬
cfo	å¬
cfe	è² å
cfu	èŠ™
cf;	èŠƒ
cf,	èŠ³
cda	èŠ–
cdo	åˆŒ
cd;	èŠ‚
cto	èŠ
ctu	èŸ èŠ åœ§
ct;	è‹—
ct/	èŒ¼
cna	èŠˆ
cno	èŒ‘
cne	èŠ®
cni	è‰¿
cla	èŠ¯
clo	è–
cle	è‰º
cli	è’š
clu	è”
cga	è‹½
cgi	åˆ„
cg;	åˆ èŠ‰
cg.	èŒ›
cg/	èŠ
cke	å»¿
cki	èŒ¾
cho	è‹‚
che	èŒ´
cji	èŠ‘
cju	è‹Ÿ èŒ
cj;	è‹‹
cj.	è³
cqa	èŒŠ
cqi	æˆŠ æˆŒ èŠ
cq;	åŒ èƒ
cxa	èŠ
cxi	èŒœ
cx.	è˜ å—
czo	è‰
czi	è¿‡ è¾º ğ¦­œ
czu	èŒ±
cz,	è‹Œ
cz.	å§ è’–
cco	èŠ€
ccu	èŒ
cso	èŠ
csu	èŠŸ
cro	èŠ‡
cr.	ä»„
cvi	ç”˜ ä¢º åˆ… è‹¢
cwe	è‹¿
cwu	èŠœ
cw;	èŠ„
cya	è‹– èŒ
cyo	èŠº
cyi	è‰¾
sbo	å¿º
sbi	åŒ‚ æ€­
spa	è€’ æ „
spi	æ€¶
sme	ä¸° ä¸¯
sm;	æ‚—
sfo	å¤
sfe	æ‚±
sf;	å¿›
sda	å¿•
sdi	çˆ¿
sd;	åŒ€
stu	å£
st;	ç”¸ ç”¾ ç•„
st/	æ«
sno	é¸´
sn/	å¼‚ å‰
sla	å¿
slo	æ…
sle	å¿†
sge	æ„…
sg;	å¿“
sg.	æ¨
sha	å³ƒ
sho	ç½ ç³
she	çŠ­ æ›
sji	å¿‹
sju	æ€
sj;	è§‰
sj.	æƒ
sj/	æƒŠ
sqi	å¿¾
sq;	æ® è€‚
sq/	è‚–
sxo	å°—
sxe	å½“
sxi	æ“
sx,	æ¦
sx/	å…‹ æ€³
szo	é¾º
szi	å·¡ æ€¾ è¾» è¿§
szu	è¾µ
sz,	æ€…
sz.	æ…
sco	å¿‰
sc.	å¯¼ å¿–
sso	ç•ƒ
ssi	åŒ…
sri	æ—¬
sr.	ä»§ å‹½
svo	æ”¯ å
svi	å‹¿ å‹»
swo	è¨‡
swe	æ€½
swu	æ€ƒ
sw,	å¿¹
sw.	æ”¶ æ”º
sya	æ€
syo	å‹¾
rbo	æ¬¥
rpa	æœ æ²
rpi	å¸”
rma	ä¼
rmo	å¸“ æ˜©
rme	æ›±
rm;	æ™š
rm.	æ˜·
rfe	æšƒ
rf;	å¸† æ˜„
rf,	æ˜‰ æ˜˜
rda	æ—²
rtu	åœ¼
rt/	æ™
rne	ç¦º
rla	å¿ æ˜—
rle	ä»Š
rg;	æ—± æ—°
rg,	æ—·
rg.	é£Ÿ
rg/	æ™
rke	æ—¦ ä¸’
rha	ä»š æ—µ
rho	ç‚… ç‚š
rje	ç”µ äº¾
rji	é£ 
rju	æ˜«
rj;	ğ¬€ª
rj/	æ™¯ æ™¾
rqo	ä»‹
rqi	æ›³
rxo	å¦Ÿ å°’
rxi	æ™’
rx,	æ™Œ æ™‘
rzi	å¸œ
rzu	æ˜¯
rz,	å¸
rco	æ—«
rcu	æ˜¢
rc.	æ—¶
rso	æ—³
rsi	ä» æ—ª
rri	æ˜Œ æ˜
rr.	ä» ä»Œ
rvi	ä»’
rv,	æ˜‚
rwe	æ˜§
rw,	æ—º
rye	æ˜
vbo	æ¬¢
vbe	é™´
vpi	é™‚
vma	é˜¯
vme	äº
vfe	é™«
vf;	é˜ª
vf,	é˜²
vda	å¤´
vd;	éŸ¦
vd/	é™ˆ
vta	é™€
vtu	åœ£
vno	é¸¡
vla	å¿ˆ
vli	éš”
vgi	å‰
vg.	é™ è‰°
vke	çºŸ
vho	é˜¦
vhe	ä¹¡
vje	äº äº
vj;	è§‚
vqo	äº•
vqi	æˆ‹
vq/	é’
vxo	ç¤º
vx.	è¾Ÿ
vzi	è¿
vzu	é™
vc.	å¯¹
vso	å…ƒ
vsi	æ–—
vri	é˜³
vr.	é˜Ÿ
vvo	åŒ
vvi	é–€ é‚“ äº–
vw.	æ•–
vyo	äº‘
vye	é˜´
wba	å…² ç
wbe	ç• è«€
wbi	çŒ
wpi	ç» è©–
wma	ç› è¨¨
wfo	å„
wfe	ç² èª¹
wfu	ç
wf;	ç“ª è¨‰
wf,	è¨ª
wta	è©‘
wto	äº¢ ç‘ å‡¦
wtu	ä¸»
wt;	å¤‡ äº© ç•—
wt/	è©·
wne	è¨¥
wn/	å¼„
wla	æ‚¥ è¨«
wlo	ç¯
wge	è«½
wgi	ç‰ çŠ
wg;	è¨ ç•
wg.	ç¢ è©ª
wg/	ç™ é¿
wki	è¨®
wha	è¨•
who	äº¦
wja	ç– ç¾
wje	äº¡ çŒ
wji	è¨˜ ç˜
wju	ç½ è¨½
wj;	ç°
wj.	ç»
wj/	è«’ ç¼
wqo	çƒ
wq;	è©®
wxo	å¥¿
wx,	ç¦
wx/	è©‹
wzi	é€™ è¿‹
wzu	ç  èª…
wz.	ç‘± è¬“
wci	è¨´
wcu	è©˜
wc;	è¨“ ç”
wc.	è¨
wso	ç“ è¨‹
wsi	è¨ˆ ç“§
wsu	è¨­ è¨†
ws.	ç… è¨·
wro	å¸‚
wri	äº¯
wr.	è¨’
wvi	å†¬ é‚¬ é‚·
wwa	ç
wwo	ç‚ èª©
ww;	è¨™
ww,	ç¨
ww.	ç«
wyo	ç„ ä¸Ÿ è¨
wye	ç¥
wyi	æ–‡
wyu	ç™
ybo	æ¬¤ è‚·
ybe	è„¾
ypa	æ€ é›¬
ym;	è„•
yfo	å° å‘‘
yfe	éœ è…“
yfu	è‚¤
yf,	è‚ª é›±
ydo	åˆˆ åˆ–
yd/	èƒ¨
yto	è‚Œ
ytu	è‚š
yt;	é›·
yt/	èƒ´
yne	å‡¶ è‚­
yn;	è„Œ
yn/	å¼ ç•
yle	å¹» è‚Š
yli	è†ˆ
ylu	è†”
yga	èƒ
ygi	æˆˆ
yg;	è‚
yka	èƒ©
yha	å²™
yja	èƒ›
yje	ç”© ä¹£
yju	æœ èƒŠ
yqo	ä¹”
yqi	æ¯›
yq;	è‚°
yq/	èƒ„
yxa	é›«
yxo	ç³¸ å¼ è‚—
yxe	é›ª
yzi	è¿ª èƒ‘ è¿Œ
yz,	èƒ€
ycu	æœ èƒ
yc.	è‚˜
yso	å… è‚‘
ysu	è‚¡
ys;	è‚œ ç³¹
ys.	èƒ‚
yra	æœ’
yr.	è‡¥ è‚•
yvo	è‡¤
yvi	é‚®
ywo	éœ…
yw;	è‚’
yya	è‡¦
yyo	å¸
yye	æœ‹
yyi	çˆ»
bbf	èœœ
bbl	ç©·
bbh	ç©¶
bbq	ç©¿
bld	å®¿
blg	ç—›
bkf	å¯Œ
bkr	å®£
bky	å®¤
bhb	å¯’
bhj	å†œ
bjm	ç˜¦
bsm	å‰²
bvs	å† 
bwf	é¢
byj	çˆ¹
ppj	æ¢¦
ppv	ç¦
pdm	æ¯
pgy	æ¨ª
pjs	æ£€
psr	æ£’
prl	æª
pwy	æ ¸
mmh	é¢‘
mtq	é»˜
mjg	é€»
mvb	èƒŒ
fmb	å˜´
fmk	è·
fmh	è·³
fms	è·‘
ffm	æ‚£
ffq	å™¨
fnl	å•¦
flh	å’–
fgp	å˜›
fkf	å‘µ
fhn	å“¦
fzd	æ–½
fzl	æ—…
fzc	æ——
fsn	é—
fsc	å–·
frs	å–
dpb	ç²‰
dpn	ç²—
dpg	ç³–
dpj	æ–­
dps	ç³Š
dpv	ç²¾
dmg	å¦
dmj	å°†
dmz	è£…
dfd	ç¢°
dfl	å·
dfk	ç¡¬
dfw	ç¢
dtt	è¡—
dnv	è€
dgm	å·
dkb	ç›Š
dkf	å…»
dkd	é€
dkn	å·®
dkh	æ™®
dkq	å‰ª
dkx	å…¼
djd	è¡¡
dxv	å°Š
dsm	å¾·
dsf	è¾‘
dsl	è¾ƒ
dsg	æš‚
dsk	è¾†
dsj	è¾“
dsv	è½»
drl	å†·
dvx	å¾„
tdm	å
tds	è½½
ttg	æˆ´
tlk	å¢ƒ
tlw	æˆª
tzk	è¶Š
tzc	è¶…
tcj	å¡”
tsd	å¢™
nbb	æ§
nbd	æŒ¥
nbj	æ“¦
nmt	æ‘†
nfn	æŸ
ndf	åœˆ
ndk	æ©
nnk	åˆ 
ngm	æŠ“
ngk	æ¡
ngx	å“²
nkg	æ‹’
nkh	æ‘„
nhd	æ’­
nhl	æŠ›
nhz	æŒº
nhs	æ‹¬
nhy	æ¬
njm	æœ
nqj	æ‰°
nxj	æŠµ
nzd	æ‹–
nzz	æ‘‡
ncj	æ­
ncs	æ’•
ncr	æ‘¸
nsf	å›º
nsl	åŠ©
nsg	æ•‘
nrd	èµš
nrl	æŠ¢
nrh	è´´
nrs	è´­
nvd	å›´
nvs	å›­
nwn	æ
nwl	åŠ¿
lbd	å€¾
lbn	è´§
lms	æ‰¿
ldl	ä¼ª
lnb	å•†
lnr	ä¾§
llk	å€
lgm	å‡
lgn	å‹‡
lgl	é¢„
lgg	å
lgc	æŸ”
lgv	ç™»
lkp	æ–°
lkf	ä½¿
lkn	ä¿©
lkh	ç«™
lkj	ä»£
lkr	ä¾¿
lky	å€’
lhf	æ¶
lhn	å‚»
lhz	å‡­
ljq	å·
ljx	æ‚¨
lxb	ä¾µ
lxn	å¥
lzf	è›‹
lzl	ä¼¤
lvm	å½•
lvj	ä¼ 
lwb	åœ
lwh	ä¾
gpp	é­”
gdg	å¼±
gnd	é˜…
gnk	é—»
gnw	é—¹
glg	åº
ggn	é
ggj	å±•
ghf	å±
ghz	åº­
gxm	åº·
gxj	åº•
gsf	å‰§
grr	åº§
kbk	æ¼”
kpr	æ¸£
kmm	æ¶‰
kmd	é¡¶
kfp	æ•´
kfm	æ­Œ
kff	æ½œ
kfd	è±†
kft	é€¼
kfk	æˆ–
kfz	æ¸¸
kdg	æ´²
kdk	æ´‹
kds	æ¸
knp	åˆº
kng	ä¸½
knj	é¡¿
knr	æµ‹
kln	æ»´
kly	æ»š
kgn	æ¶¦
khd	è”
kht	æ´—
khl	èŠ
khk	æ¶
khr	æ¿€
khv	èš
kxm	å¦»
kxv	æ¼‚
kzd	åŒ»
kch	æº
kcq	åŒ¿
ksf	æ¹–
ksz	æ·˜
krb	æ··
krm	æ¼«
kwl	æ¶²
kwh	æ¹¾
kwy	æµ
kyt	è‡´
kyj	æ¬§
kyy	çˆ½
hpd	ç¨
hpn	é€
hpl	å­£
hph	ç©†
hpj	ç§°
hpx	ç§’
hps	ç¨
hpv	ç§‘
hmt	é¼»
hdp	ç¿»
hdn	çƒ¦
hdl	ç‚¼
hdj	é€ƒ
htf	é€ 
hts	èµ
hnd	å¥¥
hnt	ç‰¹
hjg	é¤
hqk	å°„
hsm	å‰©
hsf	é€‚
hsl	ç‰ˆ
hrg	çˆ†
hyt	èˆ¹
hyk	çƒ§
hyw	èˆª
jfk	è¯¯
jdm	è¡¥
jdg	è£¤
jdk	è°±
jlk	è¯
jgn	ç¥–
jgl	æ€¨
jgk	ç¦
jkd	è¯„
jhq	è°¢
jjb	é¦†
jjz	é¥°
jxk	æ¯
jcl	è¯š
jcq	è¯º
jsk	å‰‘
jsq	è¯¸
jvl	é‡
qbg	è¢­
qmh	é›…
qsn	é”
xkf	æ
xkd	é¡¹
xkg	å§¨
xkk	å·§
xvl	åŠª
xvh	é…·
xvr	é†’
xvy	é…¸
zmv	æ€
zfd	é¼“
zdf	æ™º
zdk	çŸ­
zgg	ç¯‡
zjl	æ¯
zjs	ç­¾
zsp	ç±
zvz	ç¯®
cbl	åŠ³
cbv	è’™
clk	è–ª
clh	è‹
clj	é¡¾
clq	ç››
ckd	è‹¹
ckl	èŒƒ
ckk	è–„
ckj	åŠ±
ckw	è½
csb	æ–¯
csh	è·
csq	è‘—
crl	åš
cvl	è¨
cvk	è¯
cvz	è“
sfn	èµ
snd	å—
slh	å
slv	å–
skb	ä¸¾
skf	æ‡’
skq	åš
shf	ç‹¬
shl	çŠ¯
shc	çŒ«
shs	çŒª
shv	å¸®
shw	é€›
sql	æ•™
sxl	æ‚Ÿ
szv	éŸ©
srm	æ³°
srk	å¥
rlk	æš—
rlj	åˆ›
rgf	èˆ’
rzm	æ˜¨
rzg	æš–
rcv	æ™¨
vlk	é™ª
vkb	ç»¼
vkf	é˜¿
vkd	ç»ƒ
vkn	çº§
vkl	ç»´
vkg	ç¼–
vkk	çº¯
vkj	ç»
vkx	çº¢
vkz	ç¼“
vkc	ç»
vks	ç»­
vkv	çº¿
vkw	ç»Ÿ
vjl	æ¯’
vjx	éš
vjs	é™©
vqj	é™
vxk	åŠ²
vvy	ç´§
vyb	é­‚
wbk	è±ª
wby	æ¯«
wdm	ç¯
wln	ç†Ÿ
whf	è›®
wyn	èµ¢
wys	ç‡
wyr	åˆ»
ydf	è…¾
ydn	éœ€
yqb	ç†Š
ycr	è†œ
ysy	èƒ¸
bbbi	æ¯– ç–ª
bbpa	æˆ ç©¼ ç½™
bbmu	çª…
bbtu	å’
bbno	çª
bble	ç©µ
bbga	çªŠ
bbg;	ç½•
bbg/	ç©¹
bbha	å¯†
bbq;	çª
bbz.	çª´
bbcu	çª‹
bbsi	æ¯•
bbro	å¸˜
bbvi	ç—¯
bbyo	ç©¾
bppa	ç—² å†§ ç—³
bmbi	ç–µ
bmje	ç–¤
bmso	è¦•
bfpa	å®²
bffo	å®«
bfyo	ç—‹
bdpa	å† å®©
bdfo	å®•
bdx/	ç—¥
bdsi	å†›
btn/	ç—¹
btc.	ç—”
btyi	ç–¯
bnbo	ç˜š
bnna	ç—ˆ
bnqo	é´“ éµ¯
bns;	å®œ ç–½ å†
blme	ç–—
blm.	å¯
blda	ç–¦
blt;	ç˜¤
blna	å­—
blvi	ç–¡
blwo	å¯‰ ç—½ éšº
bgbi	ç—†
bgfo	ç˜‘
bgga	å¯™
bgqo	ç–¿
bgs;	å½®
bgri	ç˜„
bgyo	å®–
bgyu	ç˜º
bkma	ç—‡
bkme	å® ç–”
bkna	å®‡
bkne	ç—…
bkjo	ç– 
bkje	å…®
bkzo	è»
bkco	å®¶
bhfo	ç—
bhna	ç‰¢
bhle	å®„
bhho	ç—°
bhqi	å®…
bhxe	ç˜§
bhvo	åœ
bjso	ç˜¹
bjr.	ç˜
bjyo	é¬¼
bjyu	ç™™
bqba	å®¾
bqq/	å®¥ ç—
bqyo	å®
bxpa	æ¡ˆ
bxge	éŒ
bxke	ç–˜
bxje	ç–§
bxxi	ç¿‰
bxw.	æ•“
bzpa	å¯€
bzda	ç–¾
bzla	ç—£
bzle	ç–™
bcm.	ç›†
bctu	åŒ
bcn/	å¼…
bcla	å¿¿
bclu	éº„
bcha	å²”
bcho	ç‚ƒ
bcj;	å®½
bcvi	ç–³ é‚ 
bcwa	ç“«
bcw.	æ”½
bsno	é¸¨ é¸©
bsq/	å®µ ç—Ÿ
bsso	å°¦
bssi	ç–±
bsr.	å®Ÿ
bsvo	ç—©
bsvi	é‚¥
bswa	ç“­
bsw,	å°©
brm.	ç˜Ÿ
brne	å¯“
brla	å†¥
brke	ç–¸
brqo	ç–¥
brxo	å®´
brzu	å¯”
brs;	ç–¹
brr.	ç–­
bvda	å®
bvla	æ‚¹
bvje	ç–
bvqo	å®‘
bvq/	å¯ˆ
bvxo	å®—
bvx.	ç™–
bvzi	é€­
bvso	å®Œ
bwmu	ç¥
bwfo	å®¢
bwtu	ç–° å®”
bwna	æ’†
bwn/	å¼Š
bwla	æ†‹
bwgi	å®
bwg/	å½†
bwj.	é…
bwq;	ç˜
bwxo	å«³
bwro	å¹£
bwri	æš¼
bwvi	ç–¼
bwyo	ç—ƒ
bypa	æ€
byd;	çˆ·
byt;	ç™—
byla	å¿©
byqi	å®’
byso	å…Š
bywa	ç“®
byye	ç—­
pbba	æŸ¼
pbbi	æ‡
pbm.	æ¦“
pbfo	æŸ—
pbgu	æ¦•
pbxo	æ¡‰
pbx.	æ¦Ÿ
pbx/	æ¢²
pbzu	æ¤—
pbco	æŒ
pbso	æ•
pbri	æ º
pbvi	æ£º
pbyo	æ¾ æ©
pppa	æ£®
ppf;	æ¢µ
pptu	åŸœ
ppt;	æ¦ƒ
pplu	éº“
ppho	ç„š
ppxa	æ¢º
ppxo	å©ª
pps;	å½¬
ppvi	éƒ´
pmba	æ¢–
pmmu	æ¥£
pmfe	æªŒ
pmf,	æ¥
pmla	æƒ³
pmgi	æœ´
pmje	æ·
pmqo	æ¦ª
pmso	æ¢˜
pffo	æ¢ 
pftu	å 
pfq/	æ¢‹
pfco	æ´
pfw,	æ¡¯
pdbo	æ ¨
pdfo	æŸ˜
pddo	æ µ
pdna	æŸˆ
pdki	æ Ÿ
pdje	æ
pdx/	æ£
pds;	æ 
pdri	æ ¢
pttu	æ¡‚
ptla	æ¥’
ptyo	ã­•
ptyi	æ«
pnpa	æ¡—
pnda	æŸ
pntu	æŸŸ
pngi	æ
pnha	æ§
pnqo	æ¨¢
pnco	æŸµ
pns;	æŸ¤ æŸ»
pnvi	æ
pnwo	æ¬
pnyi	ã­
plbi	æ¹
pltu	æ»
plt;	æ¦´
plna	æ æ
plke	æŸ†
plhe	æœ¸
plq;	æ ¿
plxo	æ 
plc.	æŸ
plri	æ¦°
plvi	æ¨
plwo	æ¤
plyi	æ ¡
pgbi	æŸ…
pgfo	æ¥‡
pgtu	æ¡©
pgla	æ€· æ€¸
pggo	æ¦
pgg.	æ¡¹
pgqo	æŸ«
pgq/	æ¦¾
pgxa	æ
pgzi	è¿°
pgri	æ£¤
pkma	æŸ¾
pkme	æœ¾
pkna	æ…
pkne	æŸ„
pkh;	æ ®
pkjo	æ¤
pkje	æœ½
pkso	æŒ
pkro	æ®
phpa	æŸ‡
phm.	æ¡–
phfo	æ®
phfu	æŸ£
phto	æ¤ƒ
phn/	æ¡
phle	æœ¹
phgo	æ Œ
phgi	æ
phho	æ£ª
phji	æ¡¤
phqi	æ”
phzo	æ£¹
phsi	æ„
phri	æŸ
phvo	æ 
phvi	æ¡˜
pjpa	æ¢Œ
pjd;	æ¥–
pjla	æ¢
pjg.	æª­
pjso	æ£¿
pjr.	æ¥°
pjvi	æ¢©
pqba	æ¢¹
pqq/	æ ¯
pqro	æŸ¨
pxke	æ  æ¢
pxho	æ£‚ æ¨®
pxhe	æª
pxxo	æ¥†
pxxi	æ ©
pxzo	æ©
pxc.	æ¡ª
pxvi	æ¢„
pzpa	æ£Œ
pzfo	æ¡”
pzla	æ¢½
pzle	æš
pzja	æ§„
pzxo	æ¡µ
pzsi	æµ
pcfo	æŸ–
pcd;	æ ‰
pcvi	æŸ‘
psfo	æ¯
psd;	æƒ
pst;	æ¤”
psn/	æ¿
psqi	æ¡Ÿ
psq/	æ¢¢
psxa	æ¡›
psxo	æ¡œ
psxe	æ¡£
pssi	çš° æ¹
psri	æ ’
psvo	æ
psyo	æ„
prpa	æ£µ
prm.	æ¦…
prla	æ¢•
prle	æ”
prg;	æ¡¿
prke	æŸ¥ æŸ¦
prqi	æ §
prri	æ¤™
prr.	æ
pvtu	æŸ½
pvgi	æˆ
pvje	æ‡
pvqi	æ ˆ
pvq/	æ£ˆ
pvxo	æ ‡ æŸ°
pvx.	æª˜
pvc.	æ ‘
pvso	æ¬
pvsi	æ“
pvvi	æ¤š
pvyo	æŸ
pwfo	æ ¼
pwto	æ­
pwtu	æŸ±
pwn/	æ¢‡
pwje	æ§
pwro	æŸ¿
pwvi	æŸŠ
pyfo	æ±
pyt;	æª‘
pyqo	æ¡¥
pyqi	æ†
pyxe	æ¨°
pyye	æ£š
mbpa	æŸ´
mbpi	è²±
mbmu	çœ¥
mbfo	å‘°
mbf;	è²©
mbdo	å‰‡
mbjo	è§œ
mbj.	éˆ­
mbxo	å§•
mbx/	è²º
mbco	ç›¼
mbci	è²¡
mbso	çœˆ
mbra	èƒ”
mbvi	äº› éƒ¥
mbwo	è¨¾
mbw.	æ•—
mppa	ç½§
mmba	è²·
mmbo	å†– å®€
mmbi	çœ¦
mmb/	ç–’
mmpa	æœ©
mmpu	æ”´
mmma	æ­® éª‰
mmme	ä¸¨ äº…
mmmu	ç¸ ç ç½’
mmdo	åˆ‚ ä¸·
mmdi	ä¸†
mmd;	å© å†«
mmna	æ‰Œ é¾µ
mmno	é¹›
mmne	å†‚ å‡µ ç¦¸
mmni	å±°
mmn/	ä¸Œ å»¾
mmla	æ„³
mmle	ä¹›
mmli	äº»
mmgi	ä¸¶ ä¹€ ä¹
mmgu	å†
mmg/	é¾·
mmka	æ°µ
mmho	ç…›
mmhe	ä¸¿
mmhu	è™
mmja	è® 
mmje	ä¹š
mmj.	äº¼ é‡’
mmqo	ç½µ ç¬
mmqi	é’…
mmq;	ç
mmxa	ä¸…
mmxe	å½
mmxi	è¦€
mmzo	çˆ«
mmzi	è¾¶
mmzu	é¾°
mmz,	é•¸
mmco	è‰¹ ä¹‘ å„ å
mmso	å‹¹ ç
mmsu	å¿„ ä¸©
mms;	å½¡ å·›
mms,	ä¸„ é¾¸
mmr.	äº½
mmvo	é¾¶
mmvi	é˜ å·œ éƒ¿
mmv,	å¬
mmwo	äº  å‚ è¨
mmw.	æ”µ å¤‚ å¤Š
mmyo	å¶
mmyi	ä¹‚
mfbi	å”œ
mfq/	çŠ ç½¥
mfw,	çˆ
mfyi	é©¶
mdpa	çœ¯
mdna	çœ«
mdki	éªˆ
mdje	é©°
mttu	çœ­ ç½£
mtn/	ç¤
mtla	ç½³
mtqo	é»‘
mtc.	æ­­
mtyo	ç½¢
mnfo	ğ¬³¶
mnda	çœ
mnqo	ç—
mns;	é©µ ç½
mlda	ğ«˜
mlt;	éª ç½¶
mlhe	å‹‰
mlc.	é©¸
mlwo	ç¢ éª“
mgbi	çœ¤
mgma	ç¾
mgm.	ç›€
mggo	é©´
mgxa	ç›º
mkma	ç½¡ çœ
mkme	ç›¯
mkna	ç›±
mkne	çœª
mkh;	çœ²
mhfu	çœ£
mhho	ç’
mhzo	ç½©
mhye	æ­¬
mjpa	ğ¬³¿
mjdo	ç½š
mjgi	ç½—
mjha	å²Š
mjxo	çœŒ
mjxe	é©º
mjso	ç¨
mqbi	é§œ
mqpi	é§Š
mqfe	é¨‘
mqda	é¦±
mqta	é§
mqt/	é§§
mqno	ä´—
mqn/	é¦µ
mqlu	é¨¼
mqg;	é¦¯
mqju	é§’
mqqa	é§ˆ
mqq;	é§©
mqx.	é¨‚
mqzi	é¤
mqzu	é§¯
mqc;	é¦´
mqso	é¦°
mqri	é¦¹
mqvo	é¦­
mqvi	éƒ¹
mqw.	é§‡
mqya	é§
mxhe	çœ‡ æ­©
mxje	çœ‚
mxzo	ç«
mzpa	ç¬
mzle	ç›µ
mcbi	é¾€
mcfo	çœ§
mct;	ç„
mcg.	é¾ˆ
msme	ç›½
msm.	æ³´
msfo	ç½Ÿ å‘‡
msd;	ç›·
mstu	å”
mst;	ç•“
msne	å‡¼
msq/	ç„
msri	æ²“ çœ´
msr.	æ°¼
msvo	æ­§
mrpa	éª’
mrg;	ç…
mrzu	ç¼ ğ«˜¨
mrso	å…
mrs;	çœ•
mvbi	åŒ—
mvna	é©¿
mvq/	ç›
mvxo	çœ
mvso	ç›¶
mvyo	çœƒ
mwfo	éª†
mwdo	ç½°
mwtu	é©» ç½œ
mwje	ç›³
mwc;	ç“
mwc.	ç½¸
mwyo	çœ© ğ« Š
mwyi	ç›¿ ğ«˜œ
myfo	çœ™ éª€
myqo	éª„
myqi	çœŠ
myyi	é©³
fbbi	å¡
fbho	ç„
fbxo	å’¹
fbzu	å•¶
fbco	å©
fbyi	ã•®
fppa	å•‰
fmba	å“¡ è¶´ å”„
fmbi	å‘²
fmpi	è·›
fmma	è¶¾
fmm.	ç›…
fmfu	è¶º
fmf,	è¶½
fmta	è·
fmla	å¿ 
fmlu	è¹—
fmgi	åŸ
fmg.	è·Ÿ
fmki	è¶¼
fmje	å§ é‚‘
fmju	è·”
fmqo	å—
fmq;	è·§
fmq/	å•ƒ
fmxi	è·´
fmzi	è¿š
fmzu	è·¦
fmz.	è¹
fmci	è·…
fmcu	å•®
fmso	è¦ è¶µ å“¯
fmwe	è·Š
fmyo	è·ƒ
fmye	è·€
ffma	éª‚
ffme	ä¸²
fffo	å“
ffto	å’’
fftu	å ƒ
ffqo	ä¸³
ffq;	å“­
ffzu	å“«
ffri	æ›¿
ffvi	éƒ˜
ffyo	è™½ èœš
fdpa	å’ª
fdme	å–
fddo	å’§
fdgi	å‘”
fdje	å”
fdx/	å“¾
fdzi	å“’
fdsi	è¾ˆ
fdri	å’Ÿ
ftpa	å“š
fttu	å“‡
ftho	å“§
ftq/	å–Ÿ
ftzu	å”—
ftyo	å‘¿
fnpa	å˜„
fnda	å’‰
fndo	å‰
fntu	å‘¥
fngi	å¸
fnqo	é³´ é³º é´‹
fns;	å’€
fnr.	å‘˜ å‘—
fnye	å—
flbi	åª
flpa	å’»
flda	å·
fldo	å“µ
fltu	åœ
flna	å‡
flke	å¼
flhe	å»
flc.	å’
flri	å—œ
flwo	å”¯
flyi	å’¬
fgbi	å‘¢
fgme	å²
fgfo	å–
fggi	å‘
fgg.	å“´
fgqo	å’ˆ
fgq/	å——
fgxa	å¬
fgcu	å•’
fgri	å”¶
fkpi	å•µ
fkme	å®
fkda	å´
fkna	å
fkh;	å’  å’¡
fkje	å·
fkzo	è¼© å”“
fhpa	å’Š
fhmu	å’±
fhfo	å‘‚ å‘«
fhfu	å‘¹
fhto	å”¬
fhna	å½
fhn/	å‘
fhgi	åº
fhho	å•–
fhqi	å’
fhzo	å•…
fhsi	å€
fjpa	å”‹ æ¤
fjfo	å“ˆ
fjda	å³
fjdo	åˆ¥
fjd;	å”§
fjli	é¬¶
fjja	å•—
fjqo	å–£
fjso	å”²
fjvi	å“©
fqdo	å‰ˆ
fqno	é¹ƒ
fqho	å’´
fqq/	å“Š
fqro	å’˜
fqwa	ç“¹
fqyo	å°
fxke	å¿
fxhe	åµ åš
fxxo	å–“
fxxi	ç¿¡
fxzo	å˜¾
fxvo	å‘¶
fxvi	å”’
fzpa	å•‹
fzpi	æ—‡
fzfo	å’­
fzto	æ–»
fzle	åƒ
fzxo	å“¸
fzc.	å“·
fzsi	å˜
fzro	æ–¾
fzwa	æ—Š
fct;	å–µ
fcle	å‘“
fcg;	å“¶
fcvi	å’
fcyi	å“
fsfo	å’•
fsd;	å‘
fshe	å•š
fsq/	å“¨
fssi	å’†
fsri	å’°
fsvo	å±
fsvi	å»
frm.	å—¢
frne	å–
frle	åŸ
frg;	å“»
frg.	å–° é¤¥
frke	å‘¾
frje	é»¾
frqo	å¤ æ–º
frxi	å—®
frri	å”±
frvi	æ–¼
fvq/	å•¨
fvxo	å‘©
fvx.	å™¼
fvsi	å‘Œ
fvw.	å—·
fvyo	å‘
fwfo	å’¯
fwto	å­
fwn/	å“¢
fwqo	å—š
fwzi	é€
fwvi	å’š éƒ¢
fwyo	å‘Ÿ
fwyi	æ– å‘…
fybe	èœ±
fypa	èš
fypi	èš¾
fyma	èš‚
fym.	è›Š
fyfo	å’
fyfu	èš¨
fyf,	èš„
fyd/	ğ¬Ÿ½
fyta	è›‡
fyto	è™®
fyne	èš‹
fylo	è›¯
fyli	è
fylu	è°
fyga	è›Œ
fyg;	è™·
fyg.	è›
fyki	èšˆ
fyhe	è›”
fyje	è™¬
fyju	èš¼
fyj;	èš¬
fyqa	èš¯
fyqi	éŸ
fyqu	è›
fyxa	è™¾
fyxo	æ—€
fyx,	èŸ“
fyzu	è››
fyco	è™­
fyci	èš¸
fyso	å® è™³
fysu	è™¯
fyri	èš
fyw,	èšŸ
fyya	èš°
fyye	èš
dbpa	æ ¥
dbm.	ç›—
dbfo	å’¨
dbtu	å
dbla	æ£
dble	ä¹²
dbxo	å§¿
dbwa	ç“·
dbw.	å¾¶
dbyo	å½¸
dpbe	ç²º
dpmo	ç²–
dpf;	ç²„
dpda	ç±»
dpto	ç±¶
dpt;	ç•¨
dpt/	ç²¡
dplo	ç²©
dplu	éºŠ
dpg/	ç²ª ç² 
dpha	ç±¼
dpqu	ç²¬
dpxo	å¨„ ç±¹
dpxi	ç²
dpzi	è¿·
dpz,	ç²€
dpc.	ç±¿
dpsi	ç±µ
dpr.	ç±¾
dpw.	æ•‰
dpya	ç²™
dmba	é 
dmgi	ä¸
dmje	å¤¿
dmqo	é¦®
dmq;	çŠ¶
dmxo	å¦†
dmzo	å£®
dmzu	å¾™
dmsi	å†°
dmri	æ›¾
dmw.	å¤
dfbo	ç 
dfbe	ç¢‘
dfb.	ç µ
dfpa	æ¡Š
dfpi	ç ´
dfma	ç  ç ‹
dfmo	ç 
dfme	å†²
dfmu	çœ·
dffu	ç †
dff;	çŸ¾
dfdo	çŸµ
dfta	ç £
dfto	çŸ¶
dft;	é¿¬
dft/	ç¡
dfna	æ‹³
dfla	æ€»
dflo	ç¡“
dfle	ä¹­
dfgu	ç¡²
dfg;	çŸ¸
dfg,	çŸ¿
dfg.	ç¡
dfg/	å¼® ç¡”
dfki	ç ”
dfhe	ç¡˜
dfjo	ç¡® è§ 
dfji	å·»
dfj;	ç š
dfj.	ç¢’
dfqo	å¥
dfq;	ç¡‚
dfxi	ç¡’
dfzu	ç¡ƒ
dfz.	ç£Œ
dfco	åˆ¸
dfcu	ç¡€
dfsu	ç “
dfs.	ç ·
dfro	å¸£
dfwa	ç ™
dfwo	èªŠ
dfw,	å¾
ddmu	é¦– çœ˜
dddo	å†½
ddna	å†¸
ddno	ä´•
ddho	çƒ®
ddje	å½µ
ddj.	éŠ
ddqo	çƒˆ
ddxo	å§´
ddzi	è¿¾
ddri	æ˜š
dttu	å¥ å¾
dtg/	å…¾
dtzu	å¾’
dtc.	å¾…
dtri	æ›½
dnf;	å›
dnda	æ®ƒ
dndo	åˆ¤
dngi	å½¶
dnqo	æ®¦
dns;	æ®‚ å¾‚
dnr.	é¡µ
dnvi	è€Œ
dlda	å†³
dlgi	ä¸º
dlhe	å¤¯
dlwo	å‡† å¥
dgme	å¼š
dgm.	ç›‡
dgla	æ€
dggi	é¿ˆ
dgqo	å½¿
dgxa	æ­½
dgzi	è¿
dgri	å¾£
dkma	å¾
dkda	å…³
dkna	ç¾Š
dkh;	è€·
dkzi	è¿¸
dkro	å¸ˆ
dkr.	å‰
dkvi	éƒ±
dkwa	ç“¶
dhm.	æ®ˆ
dhsi	æ­¼
dhvo	å¾ƒ æ®…
djpa	å¾ å‡ƒ
djfo	å†¾
djzi	è¿†
dqco	å½»
dxpa	å‡“
dxtu	å‡
dxna	å¾‹ å†¿ è‚‚
dxke	å†®
dxvi	é…‹
dxw.	æ•š
dsbo	è½¯
dsda	è½ª
dstu	å¼
dsn/	å¥”
dslu	è¾˜
dsl.	è½®
dsg;	è½©
dsje	è½§
dsj/	è¾Œ
dsq;	è¾
dsx/	æ®‘
dszi	è¿ è½µ
dsso	ç¾Œ
dsri	æ®‰ å¾‡
dsr.	è½«
dsvo	æ­¿
dsvi	æ­¾
dsya	è½´
drm.	æ®Ÿ
drg.	é£¡ é£±
drje	å¥„
drzu	å¾¥
drsi	å•
drs;	æ®„
drye	å¥›
dvme	è¡Œ
dvje	å¤¸
dvqi	æ®‹
dvq/	å‡Š
dvxo	å¥ˆ
dvyo	å¤½
dwm.	ç›–
dwda	ç¾
dwtu	å¾€
dwla	æ™
dwgi	é¿‘
dwho	ç¾™
dwja	ç¾‘
dwqo	ç¾”
dwxo	å§œ
dyfo	æ®† å†¶
dyw.	å¾Œ
dyye	å¥Ÿ
tbba	å¹
tbbi	æ¯— æ¯˜
tbto	åˆ
tbtu	å´
tbgu	å¡
tbxo	åµ
tbzu	åŸ
tbco	å‹
tbc.	å¨
tbw.	å¤Œ ç•Ÿ
tpdo	å‰
tpqi	æ ½
tmba	å»
tmmu	å ³
tmf,	å¡„
tmgi	åœ¤
tmso	å·
tfne	åŸš
tfqi	å“‰
tfq/	åŸ
tfw,	åŸ•
tdfo	å§
tdna	ç•” å¢
tdg;	å¹¸
tdki	åª
tdje	åœ°
tdzi	å¯
tdri	å‡®
ttpa	å›
ttdo	åˆ²
tttu	ç•¦ åš
ttt;	ç•¾
ttla	æš
ttc.	å° ç•¤
ttvi	é‚½
tnpa	åœ
tnfo	å°
tnda	å±
tntu	ç•˜
tngi	åœ¾
tnqo	é³¯ é´« éµµ
tns;	å¥
tnr.	å
tnwo	å
tlda	å—
tlt;	å¡¯
tlke	åƒ
tlhe	ç”·
tlq;	å˜
tlc.	å¿
tlvi	åœº
tlwo	å †
tgbi	å­
tgfo	å 
tgg.	åŸŒ
tgqo	å²
tgxa	åœ»
tgcu	å €
tgsi	å¡‚
tkme	ç”º åœ¢ ç”¼
tkna	åœ©
tkri	å‡¬
thbo	èµ¥
thmu	å
thfo	å«
thgo	å†
thgi	åœ¦
thho	åŸ®
thji	å²
thqi	åœ« çƒ–
thsi	åœ²
thvi	éƒ å–
thw.	èµ¦
tjpa	ç•­
tjfo	å¥
tjja	åŸ³
tjso	å „
tjvi	åŸ‹
tqm.	ç›¢
txpa	å¡›
txtu	å ™
txna	å
txje	å
txxo	ã™˜
txzo	å¢°
tzbo	èµ¼
tzpa	åŸ°
tzda	å
tzle	åœª
tzg;	èµ¶
tzha	èµ¸
tzja	å¡ª
tzji	èµ·
tzj.	è¶›
tzzu	è¶
tzcu	è¶‰
tzc.	åŸ’ åŸ“
tzsu	èµ³
tzr.	é¾ª
tzyi	èµµ
tcvi	å© é‚¿
tsd;	å‡ ç•‡
tstu	å¡
tsxa	å°
tsxe	å±
tssi	å‰
tsvi	åœ½
trpa	å 
trm.	å¡­
trne	å £
trle	å…
trg;	å¾
trke	å¦
trqo	ç•Œ åœ¿ ç•
trqi	èƒ¾
trzu	å ¤
trc.	åŸ˜
trs;	ç•›
tvje	åœ¬
tvqo	ç•Š
tvq/	åŸ¥
tvx.	å£€
tvso	åƒ
tvyo	å› å‡¨
twfo	ç•¥ å ç•§
twto	å‘
twje	ç”¿
twqo	å¡¢
twyi	åŸ
tym.	ç›
tyfo	å®
tydo	åˆ¦
tyd;	å´
tyn/	å¼†
tygi	æˆ™
tyxo	ç´¯
tyzi	è¿²
tyco	åˆ§
tyr.	åˆ¼
tyye	å ‹
nbbi	æ‰¹
nbfo	å†
nbto	æŠ­
nbgu	æˆ
nbxo	æŒ‰
nbx/	æŒ©
nbzu	æŸ
nbco	æ‰®
nbso	æŠŒ
nbri	æŒ‡
nbvi	æ¾
nbw.	æ’‡
npdo	åˆ´
npke	å›°
npvi	é„¡
nmgi	æ‰‘
nmje	æŠŠ
nmq/	æ¯
nmso	æŒ¸
nmvi	æ€
nffo	æ›
nfj.	é‹¬
nfq/	æ
nfzi	è¿¥
nfzu	æ‰
nfw,	æŒ°
ndm.	ç›
ndfo	æ‹“
nddo	æŒ’
ndna	æ‹Œ
ndno	é¸¯
ndke	å› 
ndki	æ‹¼
ndje	æ‰¡
ndx/	æ
ndzi	æŒ
nds;	æ‹¦
ndvo	æŠ¥
ntpa	æŒ†
ntfo	å‘¨
nttu	æŒ‚
ntla	æŒ
ntho	æ‡
ntc.	æŒ
ntyo	æŠ¾
nnpa	æŒ…
nnda	æŠ°
nntu	æŠ©
nnna	æ‹¥ æ±
nngi	æ‰±
nnke	å†Œ
nnha	æ— æ£
nnqo	éµ‡
nns;	æŠ¯
nnye	æ 
nlda	æŠ‰
nldo	æŒ
nltu	æ‰­
nlna	å­•
nlke	æ‹‰ å›µ
nlhe	åŠ§ æ‰
nlc.	æ‹Š
nlsi	æ‰Ÿ
nlri	æ˜
nlvi	æ‰¬
nlwo	æ¨
nlyi	æŒ
ngba	å…¸
ngbi	æŠ³
ngne	æ‰ª
nggo	æŠ¤
nggi	æŠ
ngke	å›™
ngqo	æ‹‚
ngq/	æ°
ngxa	æŠ˜ æŠƒ
ngx.	æ±
ngcu	æ˜
ngri	æª
ngyo	æ‹¡
nkme	æ‰“
nkna	æ‰œ
nkne	æŠ¦
nkh;	æŒ•
nkzo	æ™
nkso	æ‰¤
nhfo	æ‹ˆ
nhfu	æŠ¶
nhn/	æŠ
nhla	æ‘…
nhle	æ‰
nhgi	å…§ æ‰–
nhho	æ
nhqi	æ‰˜
nhzo	æ‰
nhsi	æ‰¦
nhri	æ‹
njbo	æ’³
njpa	æˆ
njfo	æ‹¾
njd;	æ¤
njja	æ
njso	æœ
njvi	æš
nqba	æ 
nqbo	æ¿
nqta	é´•
nqto	é³§
nqle	é³¦
nqha	æ³
nqho	æ‹»
nqro	æŠª
nqvo	æŠœ
nqvi	é„¥
nxpa	æ®
nxke	æ‰› å›¡
nxhe	æŠ„
nxje	æ‰º
nxxi	æŒ§
nxzo	æ’¢
nxc.	æŒ¦
nzpa	æ¡
nzfo	æ‹®
nzle	æ‰¢
nzja	æ¯
nzxo	æŒ¼
nzc.	æ‹
ncfo	æ‹›
ncdo	åˆª
nct;	æ
ncke	å›¢ å›£
nczi	æŒ
ncvi	æ‹‘
nsba	å…·
nsme	æ‹œ æ‹
nsfo	å‘„
nsdo	åˆ
nsd;	æŠ£
nsgi	æ±‚
nske	å›› ç”´
nsj;	æ…
nsq/	æ
nsxa	æŒŠ
nsxo	å¦›
nsxe	æŒ¡
nssi	æŠ±
nsri	æ—¹
nsvo	æŠ€ æœ
nswo	æˆ
nsyo	å¿ æŠ…
nrpa	æ°
nrm.	æ¾
nrf;	è´©
nrdo	åˆ™
nrtu	æ
nrle	æ‰²
nrg;	æ
nrke	æ‹… å›š
nrj/	æ’”
nrqo	æ‰´
nrqi	æ‹½
nrx/	è´¶
nrzu	æ
nrz,	è´¦
nrci	è´¢
nrs;	æŠ®
nrvi	æ‰µ
nrw.	è´¥
nvmu	å†’
nvm;	å†•
nvm.	ç›ˆ
nvna	æ‹©
nvgi	æ‰ 
nvje	æ‰
nvq/	å† æ…
nvx.	æ“—
nvso	æŠ
nvsi	æŠ–
nvs;	å›¬
nvvo	ã§
nvvi	æ«
nvyo	æŠ
nwfo	æŒŒ
nwdo	åˆ
nwto	æŠ— æ‹ 
nwtu	å« æ‹„
nwna	æŒš
nwno	é¸·
nwn/	æŒµ
nwke	å›¯ åœ
nwqo	çƒ­ æ‘€
nws;	å½¤
nwyi	æŠ†
nypa	æ§Š
nyfo	æŠ¬
nydo	åˆš
nytu	å¡‘
nyt;	æ“‚
nyn/	æ‹š
nyla	æ„¬
nyle	æŠ
nygi	æ‰¾
nyke	å›œ é¾±
nyje	æ‰¥
nyqo	æŒ¢
nyzi	é¡
nyso	æŠ
nys.	æŒ¿
nyye	æ¤
nyyi	ç½‘
lbbi	ä»³
lbpa	ä¿•
lbf,	æ—
lbto	ä¼”
lbgu	å‚›
lbke	ä¼«
lbq/	ä½¾
lbxo	ä¾’
lbco	ä»½
lbsi	å
lbro	å¸
lbvi	å€Œ
lbyo	ä¼€
lpno	é¸º
lpla	æ·
lpqo	çƒ‹
lmba	è²¿
lmbi	ä½Œ
lmfo	å¾
lmto	æ¢
lmne	ğ ™¶
lmgi	ä»† å­“
lmke	å­’
lmqo	å‚Œ
lmzi	è¾½
lmso	ä¿”
lmsi	æ°¶ æ°¹
lmw.	æ”¸
lfpa	ä¿
lfme	ä»²
lffo	ä¾£
lfh,	ä¾ƒ
lfzu	ä¿ƒ
lfw,	ä¾±
lfw.	å€£
lfyo	è
ldbo	ä½½
ldpa	éº‹ ä¾
ldfo	ä½¦
lddo	ä¾‹ åˆ”
ldna	ä¼´
ldgi	ä¹¦
ldki	ä½µ
ldje	ä»–
ldx/	ä¾»
ldsi	ä¼¡
ldri	ä½°
lttu	ä½³
ltno	é¹ 
ltla	å²
ltzi	é›
ltc.	ä¾
ltyo	ä½‰ å¾
lnm.	å­Ÿ
lnda	ä½’
lnna	ä½£
lnla	å­
lnga	å­¤
lngi	ä¼‹
lnje	å­”
lnqo	é·Š
lnxo	å­™
lns;	ä¼¹ éº†
lnr.	è´¸
lnvi	é‚£
lnw.	å­œ
llt;	é¬¸
llna	ä»”
llla	æƒ¢
lllu	éº¤
llke	ä½
llhe	ä»‚
llqo	å„¦
llwo	å€ 
llyi	ä½¼
lgbi	ä¼²
lgme	ä¼„
lgne	ä»¬
lggi	ä¼¬
lgg.	ä¿
lgqo	ä½›
lgq/	å‚¦
lgxa	ä¼’
lgci	çŸ›
lgcu	å€”
lgri	å€Ÿ
lgyi	ä»ª
lkpa	äº²
lkma	ä½‚
lkme	ä»ƒ
lkfo	å¸ å’…
lkdo	ä¾€
lkto	ç«Œ
lkn/	ç«
lkh;	ä½´
lkju	ç«˜
lkxo	å¦¾
lkx/	ç«
lkzo	ç«  ä¿¥
lkco	è±™
lksi	ç«
lksu	ç«
lkro	ä¼‚
lkri	éŸ³
lhpa	éº‡
lhm.	ä¾
lhfo	åŠ  ä½”
lhfu	ä½š
lhd;	å¯
lhto	ä¿¿
lhna	ä»¶
lhle	ä»‡
lhho	å€“
lhje	åŠœ
lhqi	ä»›
lhzo	ä»» å€¬
lhzi	è¾¹
lhsi	ä»Ÿ
lhri	ä¼¯
lhvi	åŠ
lhye	ä¾œ
ljpa	ä¿†
ljfo	ä½®
ljdo	åŠ‰
ljxo	ä½ 
ljxe	ã‘‡
ljso	å€ª éº‘
ljvi	ä¿š
lqfo	ä½‘
lqq/	ä¾‘
lqro	ä½ˆ
lqvo	ä¼–
lxpa	å‚ˆ éºœ
lxfo	ä¾
lxna	ä¾“
lxke	ä»œ
lxhe	ä¼Š ä»¯
lxxo	å 
lxxi	ç¿®
lxvo	ä¼®
lzpa	å€¸
lzfo	ä½¶
lzla	ä¿§
lzle	ä»¡
lzq/	èƒ¥
lzxo	ä¿€
lzsi	ä»µ
lcfo	ä½‹
lcla	æ€¤
lcgi	ä»­
lcxo	å§‡
lcs;	å½¦
lcvi	ä½„
lsme	ä»¹
lsfo	ä¼°
lsd;	ä¼¨
lsq/	ä¿
lszi	è¿…
lssi	ä½¨ éº…
lsri	ä¾š
lsvo	ä¼ å
lsvi	ä¼†
lsw.	æ•’
lrpa	å€®
lrne	å¶
lrle	ä»±
lrke	ä½†
lrha	ä½¡
lrqo	ä»·
lrxo	ä¼±
lrzu	å
lrri	å€¡
lvda	ä¹°
lvd;	ä¼Ÿ
lvq/	å€©
lvxo	ä½
lvx.	åƒ»
lvvi	å€‘
lvw.	å‚²
lvyo	ä¼
lwpa	é›†
lwfo	å”® ä½«
lwto	ä¼‰
lwtu	ä½ éºˆ
lwt;	ä¿»
lwni	éš½
lwho	ã‘Š
lwqo	ç„¦
lwzi	é€²
lwc.	å‚ 
lwsi	éš¼
lws;	ä¿¢
lwvo	éš»
lwvi	ä½Ÿ
lwyo	ä¼­
lwyi	ä¼©
lyfo	ä½
lyno	ä´”
lygi	ä¼
lyqo	ä¾¨
lyqi	è€„
lyso	å…–
lyvi	éƒŠ
lyw.	æ•ˆ
lyye	å€—
gbba	å±„
gbbi	å± åº‡
gbla	æ…¾
gbxo	é
gbzi	è¿¡
gppa	éº»
gpmu	å»‚
gmba	å±“
gmbi	åº›
gmm.	ç›„
gmgi	çˆª
gmje	é¶ å¼
gmsi	å°¿ æ°·
gms;	æ­
gfbo	æ­„
gfdo	å‰®
gfq/	å¼² é™
gfzi	é
gfro	å±Œ
gfw,	é“
gfyo	è›¬
gdbi	å±
gdpa	å±
gdna	é½
gdki	å± åº°
gdje	å¼›
gdzi	é‘
gdsi	åº“
gttu	é‹
gtne	å±†
gtgi	åº’
gtg/	å»™
gtc.	åº¤
gnpa	é—²
gnma	é—¯
gnfo	é—®
gnda	é…
gnla	é—·
gngi	é¸
gng;	é—¬
gnke	é—©
gnja	é—¸
gnqo	é³± é³² éµ’
gnz.	é˜—
gnci	é—­
gns;	é—« é»
gnri	é—´
gnr.	é—ª å±ƒ
gnwo	è¨š
gnw,	é—°
glbi	é´
glpa	åº¥
glfo	å±€
gltu	éµ
glt;	å»‡
glna	è°»
glgi	ä¹‹
glhe	å‹’
glc.	åºœ å¼£
glsi	æ°¸
ggpa	æ 
ggme	é·
ggfo	å¯
ggfe	æ‰‰
ggf,	æˆ¿
ggda	æˆ»
ggle	æˆ¹
gglu	éº‰
gggo	åº
ggq;	æˆ¾
ggq/	è‚©
ggxa	é³ åº
ggx,	æ‰„
ggzi	è¿Ÿ å’«
ggsi	æˆº
ggsu	æ®¿
ggro	å¸
ggri	åº´
ggvi	å°½ éƒ‰ éƒ
ggyo	éƒ
gkme	åº éª
gkfo	å
gkna	å¼™
gkne	é†
gkh;	å¼­
gkzo	åº« è¼‚
gkso	é°
ghpa	é‚
ghfo	åº—
ghfu	ç“
ghto	è™’
ghle	å°»
gjbo	å» æ¬´
gjpa	åº©
gjfo	éˆ
gjdo	å‰†
gjxo	å¼¥
gjsu	å»„
gjr.	åº¾
gjvi	éƒ
gjye	æœ—
gqbo	ğ«··
gqbe	é«€
gqb.	éªµ
gqpi	éª³
gqf;	éªª
gqdo	åˆœ
gqno	é¹˜
gqg;	éª­
gqsu	éª°
gqw;	éª«
gqw.	æ•£
gqyo	è°¹
gxbo	æ¬£
gxzi	è¿‘ éŸ
gxr.	åºš
gxvi	åº® é‚¤
gzfo	éŠ
gzda	çŸ¤
gzja	é±
gzxo	é–
gcfo	å¼¨ é€
gct;	åº¿
gcgi	é±
gsmu	ç›¾
gsfo	å±…
gske	åº”
gsq/	å±‘ é˜ å¼°
gsxa	é
gsso	å…
gssi	åº– ç“Ÿ é„
gsvo	åº‹
gswo	é«
grpi	çšµ
grm.	é°
grdo	åˆ· å‰’
grno	é¹Š
grne	åº½
grle	åºˆ é²
grke	é¼
grqo	åº
grzi	é€ª
grzu	é®
gvgi	é«
gvx.	å»¦
gvro	ä¹•
gvw.	å»’
gvyo	å±‚
gwvi	åº
gwyo	å¼¦
gyba	é»„
gyqo	é’
gyqi	å°¾
gyye	å¼¸
kbba	æ³¬
kbbi	æ²˜ æ·§
kbpa	æµ¨
kbm.	ç›œ
kbto	æ²‰
kbgu	æº¶
kbq;	æ¶‹
kbq/	æ´•
kbxo	æ´
kbx.	æ»“
kbx/	æ¶—
kbzu	æ·€
kbco	æ±¾
kbso	æ²ˆ
kbs.	æ¸–
kbvi	æ¶«
kbw.	æ½
kbyi	ã³‡
kbyu	æ³»
kppa	æ·‹
kpmu	æ¹˜
kpgi	æ²­
kpj.	éŒƒ
kpxo	å©†
kps;	æ¶
kmba	æµ¿
kmbi	æ³š
kmpa	æŸ¬
kmmu	æ¹„
kmqo	æº¤
kmq;	æ¹¨
kmco	æ½ˆ
kmso	æ¶€
kmsi	æ¸‹
kmvi	é‚’
kmw.	æ”¿
kfpa	æŸ
kfme	å¯ æ²–
kfm.	ç›•
kft;	ç•
kfne	æ¶¡
kfje	åŒª åµ
kfqi	æˆ“
kfq/	æ¶“
kfzu	æµ
kfw,	æµ§
kfyo	æµŠ
kfyi	å
kdpa	æ¥ æ´£
kdfo	å æ²°
kdda	å¤¹
kddo	æ´Œ
kdtu	å‹
kdna	æ³®
kdgi	æ±°
kdki	æ´´
kdje	æ± 
kdx/	æ¶š
kdzi	è¿—
kdsi	å¹³
kdri	æ˜‹ æ´¦
ktfo	æ²¿
ktdi	æ´¬
kttu	æ´¼
ktne	ç”»
ktn/	æ· 
ktg/	æ½©
ktho	æµ¾
ktq/	æ¸­
ktc.	æ´”
ktyo	æ³•
ktyi	æ²¨
knpa	æœ¿
knm.	ç›‚
knfo	æ³‚
knda	æ³±
kntu	å†
kngi	æ±²
knha	ä¸¡
knje	å±¯
knqo	é³½
knqi	æˆ’
knzi	è¿‚
kns;	æ²®
knr.	ğ¬‡™
knvi	é‚´ é‚˜
knye	æº¯
klbi	æ²
klda	æ±º
kltu	æ²‘
klt;	æºœ
klna	æ±“
klke	æ³£ æ±ˆ
klhe	æ°»
klje	æ°¾
klqo	ç€Œ
klq;	æ´‘
klxo	æ³º
klx/	æ¸·
klc,	æµ
klc.	æ³­
klsi	æ±›
klvi	æ±¤
klwo	æ·® é›ƒ
klyi	æ´¨
kgbi	æ³¥
kgfo	æ¸¦
kggo	æ²ª
kggi	æ²¢
kgg.	æµª
kgje	å·¨
kgj.	é™
kgqo	æ²¸
kgq/	æ»‘
kgxa	æ²‚ æ±´
kgz,	æ¶¨
kgcu	æ·ˆ
kgsi	æ¸¯
kgr.	å¤·
kgyo	æ³“
kgyu	æ¼
kkma	æ³Ÿ
kkme	æ±€
kkna	æ±™
kkh;	æ´±
kkjo	ğ¬‡•
kkje	æ±‡ æ±…
kkro	æ²› æ²
khbe	è›
khma	è€»
khmu	æ´
khm.	æ´«
khfo	æ²¾
khfu	æ³†
khdo	åˆµ
khto	æ·²
khna	æ±¼
khla	æ¥ æ»¤
khle	æ°¿
khgo	æ³¸
khke	äºš
khho	æ·¡ è€¿
khje	è€´
khqi	æ±‘
khzo	æ·–
khzi	èŒ
khcu	è‰
khc,	ä¸¥
khsi	æ±˜
khri	æ³Š
khvo	å– æ³©
khvi	è€¶
khye	æ´€
kjpa	æ¶‚
kjfo	æ´½
kjgi	æ± å¼‹ å¤¨
kjke	æ¸”
kjja	æ·Š
kjje	åŒ£ åŒ›
kjqo	æ¼
kjqi	æˆ‰
kjxo	æ²µ
kjzi	è¿ˆ
kjso	æ·£
kjvi	æµ¬
kjw.	æ”·
kqba	æµœ
kqpa	æŸ’
kqho	æ´ƒ
kqqi	æˆ
kqq/	æ´§
kqco	æ²
kqri	æ›¹
kqyo	æ±¯
kxpa	æº§
kxfo	æ´³
kxtu	æ¹®
kxna	æ´¥
kxke	æ±Ÿ
kxhe	æ²™
kxje	æ±¦
kxzo	æ½­
kxzu	ç–Œ
kxc.	æµ”
kxvi	é…’
kzbo	è»Ÿ
kzpu	è»™
kzm;	è¼“
kzfo	æ´ è»
kzfe	è¼«
kzfu	æ¸“
kzf;	è»“
kzda	è»‘
kzne	è»œ
kzle	æ±”
kzlu	è½†
kzga	è»±
kzgu	è¼
kzg;	è»’
kzg/	è¼
kzha	è»•
kzja	æ»”
kzje	è»‹
kzju	è»¥
kzj/	è¼¬
kzq;	è¼‡
kzxo	æµ½
kzx/	è»¦
kzzi	é€£ è»¹
kzc.	æµ–
kzsi	æ±» è»£
kzsu	è»—
kzr.	è»”
kzw,	è»–
kzya	è»¸
kcma	æ·½
kcfo	æ²¼
kcf,	æ·“
kct;	æ¸µ
kcg.	è±¤
kcke	äº
kcki	è±œ
kcju	è±
kczi	é€
kcsu	è±›
kcvi	æ³”
kspa	æ´¡
ksme	æ²£
ksfo	æ²½
ksd;	æ±®
kstu	å™
kst;	æ·„
ksn/	æ³‹
kske	ä¸—
ksje	åŒ¹
ksq/	æ¶ˆ
kssi	æ³¡
ksri	æ´µ
ksvo	æ²’ æ±¥
ksvi	æ²•
kswo	æ¸¹
ksw,	å°«
ksyo	æ²Ÿ
krpa	æ± æ·‰ é¿„
krma	æ¶©
krm.	æ¸©
krtu	æ¶…
krno	ä´“
krne	æ¹¡
krla	æ¶Š
krle	æ±µ
krg;	æ¶†
krg.	æ¹Œ
krke	äº˜ æ³¹
krje	åŒ
krj/	æ¾‹
krqi	æ´©
krzi	è¿Š
krzu	æ¹œ
krs;	æ²´
krri	æ·
kryi	æ›´
kvd;	ğ£²—
kvna	æ³½
kvgi	æ±Š
kvje	æ±¡ æ±š
kvqo	æ±«
kvqi	æµ…
kvq/	æ¸…
kvxo	æ²¶
kvx.	æ¾¼
kvso	æ²…
kvw.	æ»¶
kvyo	æ²„
kwfo	æ´›
kwto	æ²†
kwtu	æ³¨
kwho	æ´‚
kwje	åŒ¡ æ±’
kwqo	æº©
kwri	æ¹»
kwvi	æ³ˆ
kwyo	æ³«
kwyi	æ±¶
kyfo	æ²»
kytu	è‡³
kyne	æ±¹
kyla	æµ
kyje	åŒº
kyj.	é‹ˆ
kyc.	å°‚
kyso	æ²‡
kyri	æ›º
kyyo	å€
kyye	æ·œ
hbba	å²¤
hbgu	ç†” åµ±
hbq/	è‚»
hbxo	å³–
hbco	å²
hbyo	ç‚‚
hpbe	ç¨—
hpbi	ç§˜
hppa	å´Š
hppi	ç§›
hpmo	ç§£
hpm.	ç›‰
hpfo	å’Œ
hpdo	åˆ©
hpto	ç§ƒ
hpt/	ç§±
hpni	ç§€
hpgi	ç‚¢
hpg;	ç§†
hpha	ç§ˆ
hpho	ç§‹
hpj/	ç¨¤
hpxo	å§”
hpzi	ç§¯
hpzu	ç§¼
hpz.	ç¨¹
hpso	ç¦¿
hpri	é¦™
hpr.	ç§‚
hpw;	ç§‡
hpya	ç§
hpyo	ç§ ç§—
hmba	è²
hmbo	æ¬°
hmpa	è‡¬
hmmu	åµ‹ ç…
hmfe	å¶µ
hmd;	å¹
hmla	æ¯
hmje	å²œ è‡«
hmq;	è‡­
hmx.	è¾ 
hmco	è¡†
hmso	å³´
hmsi	æ±–
hmr.	è¡‚
hmvi	éƒ‹
hfpu	æ•
hffo	ç„’
hfda	å¥Œ
hfne	ç¦¹
hfla	æ€£
hfje	ä¹©
hfj;	è§‡
hfqo	ç‚¹
hfq/	ç„†
hfzi	è¿­ è¿ 
hfyo	çƒ›
hdpa	é‡†
hdfo	å²© ç‚»
hddo	å³› å³¢
hdtu	å³š
hdna	ä¹
hdle	ä¹¥
hdje	çº
hdxe	å²¿
hds;	çƒ‚
htbo	å´
htm.	ç›§
htfo	å‘Š
httu	çƒ“
htla	æ…® å´½
htg/	ç†¼
htho	ç„ƒ
htq/	è†š ç…Ÿ
htc.	å³™
htso	å…ˆ
hts;	å½ª
htyo	ä¸¢
htyi	å²š
hnbi	ç‰
hnfo	ç‚¯ å¿
hnf,	ç‰¥
hnda	å²Ÿ ç‚´
hntu	ç‰¡ å†“
hnna	ã¶² ç”ª
hngi	å²Œ å²‹
hnjo	è§•
hnqo	å¶‹ å¶Œ
hnqi	æˆ‘
hnq;	ç‰·
hnxi	ç‰º
hns;	å²¨ è™˜
hnr.	è´ ç‰£
hnw.	ç‰§
hnya	ç‰°
hnyi	å²—
hlbi	ç‚›
hlpa	æ‚ çƒŒ
hlfo	å´
hlda	ç‚”
hltu	ç‚„
hlt;	ç†˜ åµ§
hlno	é¸ 
hlgi	å»»
hlke	å²¦
hlhe	è™ å±´
hlqo	çˆŠ
hlq;	ç»
hlxo	çƒ
hlsi	å†
hlri	æ—­ æ—®
hlvi	ç‚€
hlwa	ç”—
hlwo	å´” ç„³ è¨„ é›
hlyo	å¹
hlyi	å³§ çƒ„
hgfo	å¨ ç…±
hgno	é¸¬
hggo	ç‚‰
hgg.	å´€ çƒº
hgha	å±³
hgje	å…¦
hgqo	å²ª ç‚¥
hgxa	å²“ ç‚˜ ç‚
hgzi	ç…º è¾¼
hgcu	å´› å´« ç…€
hgra	è‚
hgri	ç„Ÿ
hkbi	é»¹
hkma	ç‚¡
hkme	ç¯
hkne	ç‚³
hkco	çƒ¼ è±¦
hkso	å±¼
hkvi	é‚º
hhbo	æ¬»
hhpa	ç§Œ
hhpu	æ•¥
hhm.	çƒ…
hhfo	å²¾ ç‚¶
hhdo	å‰¡
hhtu	çƒ¾
hhke	è™š
hhho	ç„±
hhqi	ç¹
hhzo	ç„¯
hhri	å²¶
hhvi	éƒ¯
hhye	çƒ
hjbo	å¶”
hjfo	å³† å³‡ çƒš
hjdo	å‰€
hjto	å‡¯
hjgi	å² æ­º
hjja	ç„°
hjj;	è§Š
hjqo	é¾½
hqbo	åµš
hqdo	åˆ‹
hqtu	åœ±
hqgu	è°¸
hqho	ç‚­ çƒ£
hqq/	å³Ÿ çƒ 
hqvo	å
hxtu	ç…™
hxna	å³
hxke	å±¸ ç´
hxhe	ç‚’
hxxo	å´¾
hxzo	ç‡‚
hxc.	ğ¬Šˆ
hzle	å±¹
hzja	ç†–
hzzi	é€´
hcfo	å²§ å²¹ ç‚¤
hcne	ç„«
hcg;	å²¸
hcke	è™›
hcso	çƒµ
hsme	ç‚
hsfo	èˆŒ å²µ
hst;	å´°
hsla	å¿
hsle	ç‰‡
hsja	è‡¿
hsq/	å³­ ç„‡
hsxa	å³ 
hszi	è¿
hssi	ç‚®
hsri	å³‹
hsvo	å²
hsvi	å²‰
hrbi	çš€
hrpa	æ¡Œ
hrma	å³œ
hrmo	çšŒ
hrm.	ç…´
hrf;	çšˆ
hrt;	ç• 
hrne	åµ
hrle	å²‘ å²’
hrg;	ç„Š
hrke	ç‚Ÿ
hrje	ç™¿
hrj/	ç‡
hrqo	å²• ç‚Œ
hrqi	çš‚
hrzi	è¿«
hrzu	å´¼ ç…¶
hrso	çš„ çšƒ
hrsi	çš
hrro	å¸›
hrri	ç„»
hrw,	çš‡
hrw.	æ•€
hvmu	çœš
hvd;	ç‚œ
hvna	å³„
hvha	å³Š
hvq/	å´
hvzi	è¿½
hvso	å²
hvsi	é˜œ ç‚“
hvro	å¸¥
hwfo	çƒ™ å³ˆ å³‰
hwto	è™• ç‚•
hwtu	ç‚·
hwqo	åµ¨ ç†“
hwri	å³•
hwvi	å³‚ ç‚µ
hwyo	ç‚«
hwyi	è™” ç‚†
hym.	ç›˜
hyfo	ç‚²
hyf;	èˆ¨ èˆ¤
hyf,	èˆ«
hyta	èˆµ
hyno	é¸¼
hyn/	å³…
hyg/	èˆ¼
hyha	èˆ¢
hyja	èˆº
hyj;	èˆ°
hyqo	å³¤
hyxo	ç³»
hyxi	èˆ¾
hyco	èˆ 
hysu	èˆ¬
hyvi	éƒ
hyya	èˆ³
hyye	å´© ç„©
jbbi	éˆš
jbm.	è°§
jbgu	é”
jbke	ğ¬£
jbxo	éŠ¨
jbx/	éŠ³
jbzu	éŒ 
jbco	éˆ–
jbso	éˆ‚
jbs.	è°‰
jbri	è¯£
jbvi	éŒ§
jbyo	è®¼ éˆ†
jppu	æ•
jpt;	ç•¬
jpla	æ‚†
jpgi	é‰¥
jpha	å³¹
jpqo	éŒ°
jpzi	é€”
jpvo	å™
jpw.	æ•˜
jmba	è²  é‹‡
jmmu	é‡
jmda	å¥
jmgi	è®£ é‡™
jmho	çƒ‰
jmje	è‰² éˆ€
jmqo	é·
jmq/	éŒ¹
jmso	é‹§
jmsi	æ·¾
jmri	æœƒ
jmvo	åŸ
jmvi	è°—
jfbo	æ¬±
jfpu	æ•†
jfme	éˆ¡
jfm.	ç›’
jffo	é‹
jfd;	å‘½
jft;	ç•£
jfna	æ‹¿
jfno	é¸½
jfn/	å¼‡
jfke	é¿–
jfq/	é‹—
jfzu	é‹œ
jfro	éŠ±
jfvi	éƒƒ
jfw,	é‹¥
jfyo	è§¦ é‰µ
jfyi	é‰‚
jdbe	è£¨
jdbi	è¢
jdpa	ç²‚ éŠ¤
jdpi	è¢«
jdmo	è¢œ
jdfo	é‰
jdfe	è£¶
jdfu	è¡­
jdta	è¢‰
jdtu	å ²
jdna	é‰¡
jdne	è¡²
jdgi	éˆ¦
jdgu	è£•
jdg;	è¡¦
jdg.	è£‰
jdki	é‰¼
jdje	é‡¶
jdju	è¢§
jdx,	è¥
jdx/	è¯´ é‹­
jdzu	è¢¾
jdco	åˆ
jdcu	è¢¦
jdc.	è¡¬
jds;	è¡«
jdri	è¡µ éŠ†
jdya	è¢–
jdyo	è¢„
jtfo	é‰›
jttu	è¯– è§Ÿ éŠˆ
jtla	é¶
jtq/	è°“
jtc.	è¯—
jtsu	æ¯€
jtyo	é‰£
jtyi	è®½
jnfo	è¯‡
jnda	å¥‚ é‰ 
jngi	è§™ éˆ’
jnqo	é´¨ é´ éµ– éµ¤ éµ­ é¶
jnco	ä¾–
jns;	è¯… é‰
jnr.	è´Ÿ
jnye	é™
jlbi	è®¹ éˆ‹
jlpa	éŠ
jlme	é‡•
jlda	è¯€ è§– éˆŒ
jltu	éˆ•
jlt;	é¦
jlna	è§ƒ é‡¨
jlke	å½‘ é‰
jlhe	åŠ¬ å‹ è§” é‡›
jlqo	é‘£
jlq;	æ¯‹
jlc.	é‰œ
jlsi	è®¯ æ¯Œ
jlwo	è° éŒ é›Š
jlyi	é‰¸
jgbe	ç¦†
jgbi	ç¥• éˆ®
jgma	ç¥‰ ç¥ƒ
jgme	éˆ éˆŸ
jgfo	å é‹
jgf,	ç¥Š
jgd;	å¤˜
jgtu	ç¤¾
jgni	ç¤½
jggo	éˆ©
jggi	éˆ¬
jgg;	éŠ’
jgg.	é‹ƒ
jgje	ç¤¼
jgj;	è§†
jgqo	é‰˜
jgxa	äœ£ æ–ª é‡¿
jgx/	ç¥
jgzu	ç¥©
jgz.	ç¦›
jgso	ç¤¿
jgsi	ç¥€
jgsu	ç¥‹
jgs.	ç¥
jgri	éŒ¯
jgr.	ä»¥
jgvi	ç¥ é‚œ
jgwe	ç¥™
jgyo	ç¥… é‰±
jgyi	è®®
jkpi	é²
jkma	è¯ ä½± é‰¦
jkme	è®¢ é‡˜
jkm;	ğ©¾ƒ
jkfe	é²±
jkf,	é²‚
jkdo	é‰¶
jkta	ğ¬¶
jkto	é²¦
jkt/	é²–
jkna	é‡ª ğ¬£™
jkne	éˆµ
jkh;	é‰º
jkji	é±¾
jkju	ğ¬¶‹
jkj/	é²¸
jkco	é±½
jksu	æ®µ
jkri	é²
jkya	é²‰
jhpa	é‰Œ
jhfo	é‰†
jhfu	é‰„
jhto	éŒ¿
jhna	éˆ é¼
jhle	é‡š
jhgi	é‡
jhho	è°ˆ éŒŸ
jhqi	è®¬
jhxe	è°‘
jhzo	éˆ“ é‹½
jhsi	é‡º
jhro	éŠŸ
jhri	é‰‘
jhvo	é‰
jjbo	é¥® æ¬¿
jjfo	é‰¿
jjf;	é¥­
jjto	é¥¥
jjno	é¹
jjgi	é‡¸
jjja	è°„ éŒ
jjj.	é‘«
jjqi	é¥©
jjxo	é‰¨
jjxe	è¯Œ
jjx,	é¥·
jjcu	é¥³
jjso	è§¬
jjr.	è°€
jjvi	é‹°
jjyo	é¥«
jqba	é‹²
jqbi	é®…
jqpi	é®
jqm;	é®¸
jqfe	é¯¡
jqf;	é­¬
jqf,	é­´
jqdo	ä¿ é­
jqta	é®€
jqt/	é®¦
jqne	é­¶
jqlo	é®±
jqho	è¯™
jqhe	é®°
jqja	é­»
jqji	é­¢
jqju	é®ˆ
jqj/	é¯¨
jqq/	éŠª
jqx,	é±Œ
jqzu	é®¢
jqco	é­›
jqso	æ—¢ é­¡
jqro	éˆ½
jqri	é­¯
jqr.	é­œ
jqwe	é®‡
jqya	é®‹
jqyo	éˆœ
jxpi	çš±
jxme	äº‰
jxfo	éŠ£
jxtu	ğ¬¤‡
jxna	éŠ‰
jxla	æ€¥
jxke	è®§ é‡­
jxhe	éˆ” è§˜
jxje	è§—
jxxi	è¯© ç¿ˆ
jxzo	è°­ é”
jxzi	è¿©
jxvi	é‚¹
jzfo	è¯˜ éŠ¡
jzda	é‰ƒ
jzla	é‹•
jzle	è®« é‡³
jzxo	é‹–
jzc.	é‹
jzsi	è®¸
jzro	é‰“
jcfo	è¯ é‰Š
jcf,	éŒº
jct;	éŒ¨
jcgi	é‡¼
jcqi	éŠŠ é¾¯
jcvi	é‰—
jcyi	éŠ°
jspa	è¯” éŠ‡
jsfo	è¯‚ éˆ·
jsd;	éˆ
jst;	éŒ™
jske	ä½¥
jsqo	èˆ„
jsqi	éŠ­
jsq/	éŠ· è¯®
jsx/	é‹´
jssi	é‰‹
jsri	è¯¢ éŠ
jsvo	éˆ˜
jsvi	éƒ³
jswo	é§
jsyo	éˆ
jrpa	è¯¾ éŒ
jrm.	é¾
jrne	é
jrla	æƒ¥
jrle	éˆ
jrg;	éŠ²
jrke	è§› é‰­
jrje	é¾Ÿ
jrj/	é›
jrxo	é‰©
jrzu	é‰ ğ¬¤Š
jrs;	è¯Š é‰
jrri	éŒ©
jvd;	è®³
jvna	è¯‘
jvgi	é‡µ
jvho	ç‚™
jvje	é‡«
jvqo	è®² é»’
jvqi	ğ¬£¡
jvq/	è¯· éŒ†
jvx.	é´
jvso	éˆ¨
jvsi	æ–› éˆ„
jvvi	é†
jwfo	é‰» è§¡
jwto	éˆ§
jwtu	é‰’
jwgi	éˆº
jwje	é‡¯
jwqo	é¢
jwro	éˆ°
jwvi	é‰–
jww,	éŒ±
jwyo	é‰‰
jwyi	éˆ«
jyfo	è¯’ éˆ¶
jyta	é¼§
jyt;	é³
jyne	è®»
jygi	éˆ›
jyju	é¼©
jyq;	é¼£
jyxo	éŠ¯
jyso	éˆ—
jyya	é¼¬
jyye	éŒ‹
qbgi	é¾™
qbgu	é••
qbxo	æ°¨ é“µ
qbzu	é”­
qbco	æ°›
qbw.	ğ¬­¯
qptu	ğ¬­Š
qpgi	ğ¬¬¸
qmmu	é•…
qmtu	åœ¨
qmgi	é’‹
qmhe	ç‰™
qmje	é’¯
qfme	é’Ÿ
qffo	é“
qfne	é”…
qfq/	ğ«“¶
qfro	é“
qfw,	é”ƒ
qdpa	æ°£
qdgi	é’›
qdx/	é”
qdzi	ğ«Ÿ¼
qtfo	é“…
qttu	ğ«“¯
qtla	é”¶
qngi	é’‘
qnr.	é’¡
qnyi	é’¢
qlme	é’Œ
qltu	é’®
qlt;	é•
qlqo	é•³
qlxo	é“„
qlc,	é“²
qlvi	é’–
qlwo	é”¥
qlyi	é“°
qgbi	é“Œ å±”
qgne	é’”
qgg.	é”’
qgqo	æ°Ÿ
qgxa	ğ¬¬±
qgri	é”™
qkpi	ğ¬­›
qkma	é’²
qkme	é’‰
qkdo	é“
qkne	æ°
qkh;	é“’
qhm.	ç›”
qhfo	é’»
qhfu	é“
qhgo	ğ¬¬»
qhho	æ°® é”¬
qhji	é“ 
qhsi	é’
qhri	é“‚
qjfo	é“ª
qjgi	å°¤
qjxo	é¿­
qjso	å°¥
qjvi	é”‚
qjw,	å°ª
qqq;	çŒ‹
qqq/	é“•
qqzi	è¿¶
qqro	é’¸
qqvi	éƒ
qxfo	é“·
qxke	å·¦
qxhe	é’
qxzo	é•¡
qzc.	é”Š
qcfo	ğ¬¬¿
qct;	é”š
qcvi	é’³
qsfo	é’´
qsd;	é’§
qst;	é”±
qsqo	ç‚
qsq/	é”€
qsxe	é“›
qsx/	æ°ª
qssi	é“‡
qsyo	é’©
qrpa	é”
qrm.	æ°²
qrle	é’¤
qrke	é’½
qrri	é” 
qvna	é“
qvgi	é’— çŠ®
qvqi	é’±
qvq/	æ°° é”–
qvsi	é’­
qwfo	é“¬
qwto	é’ª
qwgi	é’°
qwro	é“ˆ
qwvi	æ°¡
qwyo	é“‰
qypa	é“©
qyt;	é•­
xbbi	å¦£
xbgu	å«†
xbxo	å§²
xbzu	å©
xbco	å¦¢
xbso	å¦‰
xbs.	å©¶
xbro	å¸š
xbvi	å© 
xbyo	å¦
xmba	è³ˆ
xmmu	åªš
xmje	å¦‘
xmqo	åª½
xmso	å¨Š è¦
xmsi	éš¶
xfpa	æ¡‡
xfme	å¦•
xfna	æŒ
xfne	å¨²
xfla	æ•
xfq/	å¨Ÿ
xfzu	å¨–
xfro	å¸¤
xdpa	ç²Ÿ
xdfo	å¦¬
xdna	å§…
xdki	å§˜
xdje	å¥¹
xdxo	å°œ
xdx.	è¾¨
xdx/	å¨§
xtbo	æ­…
xttu	å¨ƒ
xtla	åª¤
xtq/	åª¦
xtri	æ›¸
xtvi	é„„
xtwa	ç”„
xnfo	å°™
xnda	å§
xntu	å§Œ
xnco	å§
xns;	å§
xnr.	è´¾
xlda	å¦œ
xltu	å¦
xlt;	åª¹
xlna	å¥½
xlgi	å»¼
xlka	äº™
xlke	äº”
xlhe	å‹¨
xlq;	è¦„
xlwo	é›€ å©
xlyi	å§£
xgbi	å¦®
xgfo	åª§
xggo	å¦’
xgg;	å§¸
xgg.	å¨˜
xgxa	å¦¡
xgx.	ç“£
xgye	è¦‡
xkma	å§ƒ
xkme	å¥µ
xkf;	å·©
xkd;	å­
xkje	ä¸
xkro	å§‰
xkvi	é‚›
xkwa	ç“¨
xkw.	æ”»
xhpa	å§€
xhmu	çœ
xhfo	å›
xhfu	å¦·
xhto	å©‹
xhho	å©’
xhqi	å¥¼
xhzo	å¦Š å©¥
xhsi	å¥·
xhvo	å§“
xjfo	å§¶
xjd;	é•·
xjle	ä¸
xjgi	æ°
xjxo	å¦³
xjx.	è¾©
xjso	å©—
xjsi	æ°’
xjro	å¸‹
xjri	æ˜
xjvi	å¨Œ
xqba	å¨¦
xqq/	å§·
xxpi	ç¿
xxn/	ç¾¿
xxg;	å§§
xxke	å¦…
xxhe	å¦™
xxju	ç¿‘
xxj/	ç¿
xxxo	å§¦ å©¹ å°›
xzpa	å©‡
xzfo	å§
xzla	å¨¡
xzja	å«
xzxo	å¨
xcfo	å¦±
xct;	åªŒ
xcx.	è¾§
xcvi	å§ ğ¬©½
xsme	å¦¦
xsfo	å§‘
xsq/	å¨‹
xsx/	å¨”
xsri	å§°
xsvo	å¦“
xrpa	å©
xrm.	åªª
xrne	åª€
xrle	å¦—
xrg;	å¨¨
xrke	å¦²
xrqo	å¦
xrzu	åª
xrri	å¨¼
xvma	é©½
xvfu	é…œ
xvta	é…¡
xvt/	é…®
xvna	æ‹
xvla	æ€’
xvg;	é…
xvg/	å¼©
xvji	é…
xvqo	å¦Œ
xvq;	é…«
xvq/	å©§
xvxo	ç¥¨
xvzi	é€
xvc.	é…
xvso	é…Œ å¦§
xvsu	é…˜
xvra	èƒ¬
xvro	å¸‘
xvyo	å¦˜
xwto	å¦”
xwtu	å¦µ
xwx.	è¾¯
xwyo	å¦¶
xwyi	å¦
xyfo	å§‹
xyqo	å¨‡
xyq/	å§¢
zbbi	å£± ç¬“
zbpa	ç­
zbto	å£³
zbso	å£²
zbvo	å—
zbvi	ç®¡
zppa	ç®–
zpmu	ç®±
zps;	å½©
zmba	ç­«
zmbo	æ¬«
zmmu	ç¯ƒ
zmd;	å¸
zmn/	ç®—
zmje	ç¬†
zmqo	ç¯¤
zmso	è¦“ ç­§
zmsu	æ®¸
zmvi	ä¹
zfbo	æ¬¯
zffo	ç­¥
zfzi	è¿¼
zfvi	éƒ†
zdfo	çŸ¥
zdje	ç«¾
zdyo	çŸ¨
zttu	ç­€
ztn/	ç®…
ztc.	ç­‰
znbe	ç¯º
znfo	ç­˜
zntu	çˆ¯
znl/	ç®‰
zngi	ç¬ˆ
znqo	é´¸ é·
zns;	ç¬¡
zldo	åˆ‰
zlna	å­š
zlgi	å»¶
zlke	ç¬ 
zlhe	ç«»
zlzi	è¿„
zlc.	ç¬¦
zlyi	ç­Š
zgm.	ç°‹
zgg;	ç­“
zgg.	ç­¤
zgqo	ç¬°
zgxa	ç¬‡
zgcu	é•¼
zgvo	çˆ°
zkpi	ç®¥
zkna	ç«½
zkg/	ç¯Š
zhbo	ç¼¼
zhb.	ç¼½
zhfo	ç¬˜
zhfu	é•»
zhd;	ç¼·
zhto	ç®
zhqo	ç¼¹
zhvo	ç¬™
zhwa	ç¼»
zjpa	ç­¡
zjfo	ç­”
zjd;	ç¯€
zxpa	ç¯¥
zxme	çˆ­
zxfo	ç­
zxna	ç­† è‚†
zxke	ç¬
zxhe	ç¬‹
zxxo	å˜¦
zxzo	ç°Ÿ
zxvo	ç¬¯
zzda	ç¬¶
zzzo	å£µ
zcbe	è²
zcfo	ç¬¤
zcne	è±½
zcg;	è±»
zcg.	è²‡
zcju	è±¿
zcci	è±º
zccu	è²€
zcso	è±¹
zspa	ç­™ é«¤
zspi	é«²
zsf,	é«£
zsd;	ç¬‰
zsto	é« 
zsg/	é«¸
zsqu	é«·
zsq/	ç­²
zsxe	ç­œ
zszi	è¿•
zsz.	é¬’
zssi	ç¬£
zsri	ç­
zsvi	ç¬
zrdo	åˆ¶
zrle	ç¬’
zrg;	ç­¸
zrg.	ç¯’
zrke	ç¬ª
zrw.	å¤
zvqi	ç¬º
zvq/	ç®
zvso	ç¬
zwfo	ç¬¿
zwto	ç¬
zwn/	ç­­
zwje	ç¬€
zwvi	ç¬—
zybe	ç°²
zyfo	ç¬
zyda	å¥š
zyn/	ç¬²
zyqi	ç¬”
zyyi	ç¬…
cbba	èŒ“
cbbi	èŠ˜
cbpa	è£
cbtu	èŒ” è’¬
cbno	èº
cbgu	è“‰
cbke	è‹
cbho	è§
cbj.	è“¥
cbxo	èŒ
cbzu	è£
cbco	èŠ¬
cbvi	è…
cbw.	è”½
cppa	è»
cpmu	å¢ è‘™
cpfo	è•
cptu	è°
cmbi	èŒˆ
cmmu	è‘¿
cmn/	è›
cmje	èŠ­
cmso	è§
cfbo	æ¬©
cfbi	å‘
cffo	è’
cfdo	åˆŸ
cfd;	å²
cfne	è´
cfla	è•œ
cfke	éŸ®
cfqi	å’¸
cfzi	è¿¢
cfzu	è¡
cfsi	å·¶
cfvi	é‚µ
cfwe	è‹
cfyo	èŒ§
cdbo	èŒ¨
cdpa	ç²œ
cddo	èŒ¢
cdki	è“
cdx/	èŒ
cdzi	è™
cdsi	å
ctbo	è°
cttu	å“ èŒ¥
ctno	é¹‹
ctla	è‘¸
ctgi	å‹
ctja	ç¾
cnbo	å¥
cnfo	è‹˜
cnfu	è´
cnda	è‹±
cntu	è‹’
cnna	è‹š
cngi	èŠ¨
cnqo	è”¦ é³« é³­
cns;	è‹´
cnya	è—
cnye	è’´
clbi	èŠ±
clpa	èŒ 
clda	èŠµ
cldo	è‚
cltu	è–¼
clt;	è’¥
clna	èŠ“
clno	ğ¬Ÿ
clni	èŠ¿
clke	è‹™
clha	è‹®
clhe	å† è‰»
clje	å„
clqo	è—¨
clqi	æˆ
clq;	èŒ¯
clzo	èŒŒ
clc.	è‹»
clri	è“
clvi	èŠ¢
clwo	è‘ é›ˆ
clyi	èŒ­
cgbi	è‹¨
cgfo	èµ
cgga	è“
cggo	èŠ¦
cgg.	è¨
cgqo	èŒ€
cgqi	æˆ
cgq/	è“‡
cgxa	èŠ¹ è‹„
cgcu	ä“›
cgri	å
cgyo	è‹°
ckpa	è¯
ckpi	è 
ckma	é¿Š
ckme	å… è‰¼
ckdo	è† èŠ
ckna	èŠ‹
ckne	è‹ª
ckg/	è‘“
ckho	ç‚—
ckh;	èŒ¸
ckjo	å‰
ckje	ä¸–
ckzo	å™ è—
cksu	èˆ
ckro	èŠ¾
chfo	è‹«
chfu	è‹µ
chto	è€
chle	è‰½
chho	è¼
chqi	å‡ çƒ•
chzo	ä“¬
chsi	èŠŠ
chri	è‹©
chvo	è‹¼
cjpa	è¼
cjfo	è…
cjdo	è‘ª
cjd;	è­
cjgi	èŠ•
cjja	è
cjso	è–
cjr.	è¸
cjvi	å˜ è²
cjw.	æ•¬
cqfo	è‹¥
cqn/	è½
cqja	å£
cqco	è‹†
cqvo	è‹ƒ
cxfo	èŒ¹
cxd;	èŒš
cxna	èŒŸ
cxhe	èŠ›
cxje	èŠª
cxqi	å¨
cxxo	è‘½
cxzo	è•ˆ
cxc.	è¨
cxvi	è¤
czpa	èœ
czg/	è•»
czha	å’
czja	è“
czxo	è½
ccfo	è‹•
ccqi	èŒ‚
ccco	åˆ•
ccvi	è‹·
csba	å…¶
csfo	è‹¦
cst;	è‘
csq/	è¦
csxo	èŒ®
cssi	è‹
csri	è€
csvo	èŠ°
csvi	èŠ´
csw.	è
csyo	èŠ¶
crbi	èŠ²
crpa	èŒ¶ è’ è“
crm.	è’€
crda	è«
crne	è¬
crla	èµ
crle	èŠ©
crqo	èŠ¥
crxo	è‹¶
crc.	è³
crri	è–
crr.	è‹
crye	èŒ
cryi	èŒ°
cvpa	æŸ
cvd;	è‹‡
cvgi	èŠ†
cvhe	èŠ—
cvje	èŠŒ
cvq/	è
cvxo	ç¥Ÿ
cvx.	è–œ
cvso	èŠ«
cvvi	é‚¯ è›
cvw.	å« è”œ
cvyo	èŠ¸
cvye	è«
cwfo	èŒ–
cwto	è‹€
cwje	èŠ’
cwsu	è”
cwvi	è‹³
cwyi	èŠ 
cyfo	è‹”
cydo	è‹…
cyt;	è•¾
cyju	è‘‹
cyqo	è
cyqi	èŠ¼
cyvo	è£
cyyo	èŒ²
cyye	è 
sbgu	æ„¹
sbx/	æ‚…
sbso	å¿±
sbri	æ‰
sbvi	æ‚º
sbyo	å¿ª
sppa	æƒ
sppi	è€š
spgi	æ€µ
spvi	è€œ
smf,	æ„£
smso	æ‚“ è¦š
smsi	æ³¶
sfpa	æ£ 
sfme	å¿¡
sffo	å–¶
sftu	å ‚
sft;	ç•¶
sfna	æŒ
sfno	é¸ª
sfla	æ€˜
sfq/	æ‚
sfx.	è¾œ
sfso	å…š
sfro	å¸¸
sfwa	ç“³ ç“½
sfw,	æ‚œ
sfw.	æ•…
sfyo	è›
sfye	èƒ¡
sdpa	åŒŠ ç‰€
sdfo	ğ¬’ˆ
sdna	æ€‘
sdgi	å¿²
sdki	æ²
sdje	å¿š
sdq;	ç‹€
sdxo	å¦
sdx/	æ‚¦
sdzo	å£¯
stna	é¼¡
stla	æ„¢
stja	ç•
stc.	æƒ
styo	æ€¯
snfo	å°š
snda	æ€
sngi	å¿£
snqo	é´¬
sns;	ç›´ æ€š
slpa	æ˜
slda	å¿«
sltu	å¿¸
slna	å­¦
slgi	å»µ
slhe	åŠ´ å¿‡
slri	æ„­
slvi	ç•…
slwo	æƒŸ
slyi	æ”
sgbi	æ€©
sgg.	æ‚¢
sgqo	æ€«
sgq/	æ„²
sgxa	å¿» å¿­
sgri	æƒœ
skba	å…´
skma	æ€”
skme	å¿Š
skne	æ€²
skje	æ°‘
skso	å…‰
shbe	çŒˆ
shpa	ç‹‡
shpi	ç‹“
shma	çŠ¸
shm.	æ¤
shfo	æ€—
shfe	çŒ…
shfu	æ€¢
sht/	ç‹ª
shlo	ç‹«
shle	å‹¼
shga	ç‹
shgi	åŒ
shg;	çŠ´
shg,	çŠ·
shg.	ç‹ 
shho	ç‹„ æƒ”
shja	ç‹
shji	æº
shju	ç‹—
shj/	çŒ„
shq;	çŠ¾
shzo	æ‚¼
shci	çŠ²
shc.	å¯¿
shso	çŠ³
shsi	å¿
shri	æ€•
shvo	æ€§
shvi	é‚¦
shwo	ç‹º
shw;	çŠ±
shw,	ç‹‚
sjpa	æ‚‡
sjfo	æ° åŒŒ
sjgi	åŒ‡
sjke	é²
sjja	æƒ‚
sjxe	ã¤˜
sjsu	åŒ“
sjvi	æ‚
sqdo	å‰Š
sqho	æ¢
sqju	è€‡
sqzi	é€
sqro	æ€–
sqri	è€…
sxpa	æ…„
sxpu	æ•Š
sxdo	å‰‹
sxje	å¿¯
sxzo	æ†›
sxc.	å°…
sxsi	å…™
sxvo	å” æ€“
szfo	æ„
szle	å¿”
szha	åŒ‹
szja	æ…†
szje	ä¹¹
szsi	å¿¤
szr.	å€
szye	æœ
scpa	æ¡’
scfo	æ€Š
scke	å‹
scq;	æ¹
sczo	æ„º
ssfo	æ€™
ssdo	åˆ¨
ssg/	å·½
ssqo	ç‚°
ssq/	æ‚„
sssi	æ€‰
ssri	æ‚
ssvo	å¿®
srpa	å·¢ å·£ æƒˆ
srm.	æ„ 
srna	å¥‰
srle	å¿´
srg;	æ‚
srke	æ€›
srja	èˆ‚
srje	åŒƒ
srj.	éŠ
srj/	æ†¬
srqo	å¿¦
srq/	è„Š
srzi	è¿¿
srzu	æƒ¿
srsi	å˜
srri	æ˜¥
srvi	éƒ‡
svdo	åˆ
svtu	æ€ª
svna	æ€¿
svla	å¿½
svgi	åŒ†
svq/	æƒ…
svso	å¿¨
svri	æ›¶
svvi	ğ¨™¸
svw.	æ… 
svyo	å° å¿¶
swfo	æª
swto	å¿¼
swje	å¿™ åŒ„
swyo	æ€°
swyi	å¿Ÿ
syfo	æ€¡
syne	åŒˆ å¿·
rbbi	æ˜†
rbxo	æ™
rbco	å¸‰ æ˜
rbso	å¸
rbyo	æ˜–
rppa	æ™½
rppu	æ•¤
rmje	å¸Š
rmso	æ™›
rmsi	æ°½
rmvo	æ›¼
rdki	å¸¡
rdqo	æ˜¦
rdx/	å¸¨
rdsi	ä¼
rdri	å¸
rtfo	èˆ
rttu	æ™†
rtc.	æ™‚
rnda	æ˜ 
rnla	æ„š
rngi	æ˜…
rnzi	é‡
rlbo	æ¬¦
rlfo	å«
rlla	å¿µ
rlgi	ä»¤
rlke	æ˜±
rlje	ä»“
rlvi	æ—¸
rlwo	å¸·
rlyi	æ™ˆ
rgbi	æ˜µ
rgfo	èˆ
rggo	æ˜ˆ
rgg.	ã«°
rgqo	æ˜²
rgxa	æ˜•
rgsi	ç•¢
rgwo	è¬ˆ
rgyo	æ˜¿
rkma	æ˜°
rkme	å¸„
rkda	æ˜Š
rkna	æ—´
rkne	æ˜ æ˜º
rkro	æ˜
rhfo	å¸–
rhfu	å¸™ æ˜³
rhn/	æ˜‡
rhle	æ—¯
rhke	æ˜¾
rhho	æ™±
rhzo	æ™«
rhri	å¸•
rhvo	æ˜Ÿ ç” 
rjbo	é£²
rjbi	é£¶
rjfo	å¸¢
rjf;	é£¯
rjto	é£¢
rjt/	é¤‡
rjg;	é£¦
rjqo	ç…¦
rjx,	é¤‰
rjcu	é£¿
rjso	æ™²
rjs;	å½±
rjr.	é£¤
rjyo	é£«
rqgi	æ›µ
rqq;	çŒ’
rxke	ä»
rxzo	æ›‹
rzbi	åŒ™
rzja	å¹
rzzi	éˆ
rzsi	æ—¿
rcfo	æ˜­
rcr.	æ˜ƒ
rsd;	æ˜€
rsq/	å¸©
rsvi	æ˜“ æ˜’
rrtu	å
rrla	æ€‚
rrle	æ˜‘
rrg;	æ™˜
rrke	ä¸›
rrho	ç„¸
rrj/	å¹œ æš»
rrs;	æ˜£
rrri	æ™¶ æ™¿
rrr.	ä¼—
rvd;	å¸ ğ¬€©
rvq/	æ™´
rvxo	ä½˜
rvyo	ä¼š æ˜™
rwvi	æ˜¸
rwyo	æ˜¡
rwyi	æ—» æ—¼
rym.	ç›Ÿ
ryn/	æ˜ª
ryho	ç„½
vbbi	é˜°
vmba	è²¬
vmso	è¦Œ
vmsi	é˜¥
vftu	åŸ…
vdje	é˜¤
vdzi	è¿
vdsi	é˜µ
vdri	é™Œ
vdr.	éŸ§
vtzu	é™¡
vtyo	é˜¹
vnne	é™†
vnqo	éš é³®
vns;	é˜»
vns,	é‘
vnr.	è´£
vlhe	åŠ é˜
vlc.	é™„
vlsi	é˜ 
vlwo	éš¾ é™®
vkma	é˜·
vkfe	ç»¯
vkf,	çºº
vkto	ç»¦
vkt;	ç»†
vkne	çº³ é™ƒ
vkl.	çº¶
vkge	ç¼‚
vkgu	ç»¤
vkg,	çº©
vkji	çºª
vkj/	ğ«Ÿ…
vkzo	é™£
vkzi	ç»‡
vkz.	ç¼œ
vkcu	ç»Œ
vkc;	ğ¬˜“
vkc.	çº£
vkso	çº¦ é˜¢
vksu	çº 
vks.	ç»…
vkr.	çº«
vkw;	çº¨
vhfo	é˜½
vhn/	é˜©
vhji	ğ¬®¿
vhsi	é˜¡
vjpa	é™¤
vjgi	ä¸“
vjja	é™·
vjzi	è¿ƒ
vjso	ğ¨º™
vqm.	ç›
vqdo	åˆ¬
vqtu	å“
vqno	ä´–
vqgi	ä¸¼
vqj;	é“
vqqi	é”
vqq/	é™
vqzi	è¿›
vqvi	éƒ¬
vxpa	æª—
vxtu	å£ é™»
vxna	æ“˜
vxno	ä´™
vxla	æ†µ
vxj.	é¾
vxq/	è‡‚
vxxo	å¬–
vxzi	é¿
vxco	åŠˆ
vxro	å¹¦
vxwa	ç”“
vxwo	è­¬
vzm.	ç›‘
vzle	é˜£
vzj;	è§ˆ
vzj.	é‰´
vzri	ä¸´
vcla	æ€¼
vsdo	åˆ“
vstu	å–
vsle	ä¹§
vsq/	é™—
vszi	è¿œ
vsvi	é‚§
vrtu	å  é™§
vrne	éš…
vrqo	é˜¶
vrzu	éš„
vrz,	éš‚
vvbi	é–Ÿ
vvpa	é–‘
vvfo	å•
vvf,	é–
vvtu	åš
vvla	æ‚¶
vvg;	é–ˆ
vvg/	é–§
vvke	ä¸ é–‚
vvki	é–‹
vvha	é–Š
vvho	ç„›
vvhe	é–
vvja	é–˜ é–°
vvqo	é˜±
vvq/	è‚¾
vvxa	é–‡
vvxo	é™…
vvxi	é–ª
vvx.	éš¦
vvz.	é—
vvci	é–‰
vvso	é˜®
vvsi	é˜§
vvs;	é–†
vvri	é–“
vvr.	é–ƒ é–„
vvvo	å’
vvwo	èª¾
vvw,	é–
vvw.	éš
vvye	é–’
vwma	éªœ
vwfo	å—¸
vwto	é˜¬
vwna	æ‘®
vwha	å¶…
vwj.	éŠ
vwqo	ç†¬ éš–
vwq;	ç’
vwxo	å«¯
vwzi	é¨
vwwo	è¬·
vygi	æˆ
vyxo	ç´ 
vyzi	è¿
vyso	é˜­
wbbi	ç­
wbm.	è¬
wbto	äº®
wbgu	ç‘¢
wbx/	èªª
wbzu	ç” è«š
wbco	ç¢ ç“° è¨œ
wbso	è¨¦
wbri	è©£
wbvi	ç¯
wbyo	è¨Ÿ çœ
wppa	ç³ è«ƒ
wpgi	è¨¹
wmba	ç¼
wmbi	ç¼ è¨¿
wmmu	ç‘‚
wmgi	å¤„ è¨ƒ
wmje	é¿±
wmqo	ç‘ª
wmso	ç¾ èª¢
wfme	è¨²
wfq/	ç„
wfzu	ç¿
wfw,	çµ
wfw.	æ•‹
wdpa	å¤ˆ è©¸
wdna	è©Š
wdki	èª
wdje	è¨‘
wdx/	èª¬
wdri	ç“¸
wdw,	ç­
wtdi	çŸ
wttu	çª è©¿
wtla	æƒ« è«° ğ …¤
wtja	ç•
wtq/	è¬‚
wtzi	è¿’ è¿¬
wtc.	è©©
wtsu	æ®¶
wtr.	ç•’
wtvi	é‚Ÿ
wtyo	ç ç•† è©“
wnfo	é«˜ è©—
wnda	è©‡
wntu	çƒ
wngi	è¨¯
wnqo	é³¿
wns;	è©› ç‡
wnwo	ç¬
wlbi	è¨›
wlme	äº¨
wlda	è¨£ ç¦
wlt;	ç‘ 
wlna	äº«
wlhe	åŠ¡ ç
wlxo	ğ¬›
wlc.	è©‚
wlsi	è¨Š
wlvi	çš
wlwo	èª° çŸ
wlw.	å¤œ
wlyi	ç“ è©¨
wgme	è¨ 
wgfo	è«£
wggi	è¨³
wgg;	è©½
wgg.	ç… èª
wgxa	ç£ è¨¢
wgx.	è¬˜
wgcu	èª³
wgri	è«
wkma	è¨¼
wkme	è¨‚ ç
wkna	ç— è¨
wkh;	ç¥ èª€
whpa	æ ¾ è¨¸
whmu	è©¯
whfo	ç· è©€
whfu	è©„
whda	å¥•
whto	ç¥ è«•
whna	æŒ›
whno	é¸¾
whn/	å¼ˆ
whla	æ‹
whle	è¨…
whgi	äºª
whg/	å¼¯
whha	å³¦
whho	è«‡ ç°
whj.	éŠ®
whqi	è¨—
whxo	å¨ˆ
whxe	è¬”
whzo	ç¸
whzi	è¿¹
whsi	ç“©
whra	è„”
whro	å¸Ÿ
whri	ç€
whvo	å˜ ç„
whw.	å¤‰
whye	ç˜
wjpa	æ—
wjmu	ç›²
wjfo	ç¨ è©¥
wjla	å¿˜ èª‹
wjh,	å·Ÿ
wjja	è«‚
wjq/	è‚“
wjxo	å¦„ ç
wjso	èª½
wjr.	è«›
wjvi	ç† é‚™ ç“¼
wqbo	æ­
wqme	å¤…
wqho	è©¼
wqq/	ç› è©´
wqvi	é„”
wxpa	ç‘®
wxtu	è«²
wxna	ç’
wxke	è¨Œ ç’
wxhe	è¨¬
wxxi	ç è©¡
wxzo	è­š
wxc.	ğ¬¤
wxvo	è©‰
wzfo	è©°
wzla	èªŒ
wzle	è¨–
wzha	ç¤
wzja	ç‘« è¬Ÿ
wzsi	è¨± ç
wcfo	è©” ç¿
wcqi	ç¬
wcvi	çµ è©Œ
wspa	èª„
wsme	å¤† ç¤
wsfo	è©
wsq/	ç‘ èªš
wsxo	ç±
wsxe	ç°
wssi	ç¸
wsri	è©¢ ç£
wrpa	èª²
wrm.	ç‘¥
wrla	èª æ´
wrle	çª è¨¡
wrke	è©š
wrj/	ç’Ÿ
wrqo	ç 
wrxo	äº°
wrzu	ç‘… è«Ÿ
wrs;	ç è¨º
wrri	ç© èª¯
wvd;	ç®
wvgi	è¨
wvq/	è«‹
wvso	ç©
wvw.	ç’ˆ è¬¸
wwbi	ç‘Ÿ
wwpa	ç¹
wwfo	ç è©»
wwtu	è¨»
wwgi	ç
wwqo	ç‘¦
wwr.	ç¡
wwwo	è­¶
wwyo	ç¹ è©ƒ
wwyi	çŸ
wyfo	å ç† è©’
wydo	åˆ˜
wyt;	ç•œ
wyne	è¨©
wyn/	å¼ƒ
wyla	å¿
wyqo	é½
wyqi	ç“±
wyq/	è‚²
wyzi	è¿™
wyc.	å¯¾
wyso	å…… ç§
wys;	å½£
wyr.	äº¥
wyyi	è¨¤
ybbi	è‚¶
ybxo	èƒº
ybx/	è„«
ybzu	è…š
ybco	æœŒ è‚¦ é›°
ybsi	è‚¸
ybri	è„‚
ybw.	å¤‹
yppa	éœ–
ypmu	éœœ
ypdo	åˆ¹
ypsu	æ®º
ymba	è²Ÿ
ymgi	å§
ymje	è‚¥
yfpa	æ²
yfme	è‚¿
yfdo	åˆ£
yfne	è„¶
yfla	æ€ 
yfho	ç‚±
yfje	ä¹¨
yfx.	è¾
yfzi	è¿¨
yfvi	é‚°
yfwa	ç“µ
yfw,	è„­
ydpa	è„’
ydmu	è„œ
ydfo	é›¼
ydt;	ç•š
ydna	èƒ–
ydgi	è‚½
ydki	èƒ¼
ydje	è‚”
ydx/	è„±
yds;	å‚ å
ydvo	æœ
yttu	èƒ¿
ytla	è…®
ytg/	éœ¬
ytyo	èƒ 
ynda	èƒ¦ é›µ
yngi	é›­
ynqo	é´
ynso	å…‡
ynr.	è´ 
ynvi	å†‘ ğ¨š•
ylt;	éœ¤
ylgi	å»¸
ylke	é›´
ylhe	å¹¼ è‚‹
ylqo	è‡•
ylc.	èƒ•
ylvi	è‚ 
ylwo	éœ è„½
ylyi	èƒ¶
ygbi	èƒ’
ygpa	ä¹—
ygfo	è…¡
ygdo	åˆ’
ygd;	è…³
ygtu	è„
ygg.	æœ–
ygqo	èƒ‡
ygxa	è‚µ
ygzi	è…¿
ygri	è…Š
ygye	éœ¸
ykpa	éœ‚
ykt/	éœ˜
ykg/	éœŸ
ykje	ç”¹
ykco	è±š
ykso	å°§
ykro	è‚º
yhfo	èƒ‹
yhfu	èƒ…
yhna	ç‰Ÿ
yhle	è‚
yhgo	èƒª
yhho	è……
yhri	èƒ‰
yhvo	èƒœ
yjso	éœ“ è…‰
yjr.	è…´
yqfe	æ¯´
yqho	è„„
yqq/	è‚´
yqxo	æ¯œ
yqxi	æ¯¢
yqs;	æ¯
yqro	å¸Œ
yqyo	è‚±
yxpa	ç§‰
yxke	è‚›
yxxo	è…°
yzm.	ç›£
yzda	çŸ£
yzle	è‚
yzj.	é³
yzxo	è„®
yzc.	è„Ÿ
ycvi	é›¸
ysbe	ç¶¼
ysb.	çµŠ
yspi	ç´´
ysme	è‚¨
ysm;	çµ»
ysfo	ğ¦™¶
ysfe	ç·‹
ysf,	ç´¡
ysta	ç´½
yst;	ç´°
yst/	çµ§
ysne	ç´
ysge	ç·™
ysgu	ç¶Œ
yshe	çµ—
ysje	ç³º
ysji	ç´€
ysju	çµ‡
ysj/	ç¶¡
ysq;	ç´ çµŸ
ysq/	éœ„
ysxi	çµ¤
yszu	çµ‘
ysz.	ç¸
ysco	ç³¿
yscu	çµ€
ysc;	ç´ƒ
ysc.	ç´‚
ysso	ç´„
yssi	èƒ é›¹
yssu	ç³¾
yss.	ç´³
ysr.	ç´‰
ysvo	è‚¢
ysvi	é‡ è‚³
ysw;	ç´ˆ
ysya	ç´¬
yrpa	è…‚
yrm.	è…½
yrne	è…¢
yrle	è‚£
yrke	èƒ†
yrje	é›»
yrs;	èƒ—
yvtu	å …
yvna	æ”
yvgi	è‚
yvje	é›© è‚Ÿ
yvj.	é‹»
yvqo	è‚¼
yvq/	è… è…ˆ
yvxo	ä¡ å©œ
yvx.	éœ¹
yvso	æœŠ
yvyo	é›²
ywfo	èƒ³
ywto	è‚®
ywyo	èƒ˜
ywyi	é›¯
yypa	è„
yyfo	èƒ
yyno	é¹
yyn/	è…—
yyho	ç‡›
yyqi	é›®
yyxe	è†¤
yyw,	æœ¢
yyyo	å½
bbbb	çª½
bbfm	çªœ
bbfn	çª
bbfj	çª¥
bbfs	çªº
bbfy	èœœ
bbdb	æ¯™
bbdp	ç²Š
bbdq	çª¯
bbdx	çª­ ç«‚
bbdz	é‚ƒ
bbds	çª²
bbtt	çª
bbtj	ç«ƒ
bbtx	ç«ˆ
bbnt	å¯—
bbnq	çªµ é´ª
bblb	ç«‰
bbld	çªŒ
bblt	çª±
bblh	ç©·
bblr	çª¨
bbly	çª”
bbgf	çª©
bbgg	çª³
bbgc	çªŸ
bbkd	çª·
bbkt	çª’ çªª
bbkn	ç©» çª‰ çª
bbkj	çª€
bbkq	çª¢
bbkz	ç˜’
bbks	ç«€
bbhf	çª– ç«†
bbhd	çª•
bbhn	ç«Š çª‚
bbhl	ç©¶ çª¸ çª»
bbhg	çª® çª†
bbhk	çª—
bbhh	å‹“
bbhq	é¶›
bbhz	çª§
bbhr	çš†
bbhw	ç«…
bbjd	çª¬
bbjg	ç©¸
bbjj	çª
bbjy	ç«„ ç˜£
bbqh	ç©¿
bbqq	é¶Ÿ
bbqc	çªƒ
bbxf	çª˜
bbxk	ç©º
bbxj	çª
bbxq	éµ¼
bbzb	ç«‡ çª¾
bbzh	çª‘ çª°
bbzz	å¯² ç™¡
bbzv	çª„
bbcq	çªš
bbsp	çª¼
bbsf	çª¹
bbsd	çª¦ çª«
bbsn	çª™
bbss	çª‡
bbrb	çª¤
bbrp	çª 
bbrx	çª¶
bbvq	ç©½
bbvx	çª›
bbvv	çª¿ çª¡
bbws	çª£
bbyp	æ¢¥
bbyl	çª“
bbyh	çªˆ
bbyq	æ¯ ç«
bmbx	ç™­
bmmb	è³”
bmmv	ç˜
bmmw	ç™¯
bmtt	ç™¦
bmld	å®
bmkd	å¯° ç™
bmjb	çœ é¡š
bmjl	é¼
bmjq	é·†
bmsb	æ½
bmsk	å¯·
bmsr	é¢
bffh	ç™Œ
bffs	ç™‰
bfkh	å®º
bfhf	å®®
bfzd	ç˜¯
bfrv	ç˜€
bdpx	ç˜˜
bdmb	é ƒ
bdmm	å¯•
bdmf	ç—
bdmv	å¯
bddx	ç™‚ å¯®
bdnc	å¯¡
bdnr	é¡·
bdkm	å¯„
bdkn	ç—’
bdkg	ç™¢
bdkk	ç˜¥
bdhw	ç™¥ ç™“
bdzw	ç™
bdcd	å†¢ ç˜ƒ
bdsp	çš²
bdsv	éƒ“
bdrj	ç—·
bdrz	ç˜²
bdrs	ç˜…
bttx	ç™³
btnq	é´§
bthy	ç˜‹
btyx	ç˜°
bngb	ç—¶
bnsk	ç—¼
bnrx	ç˜¿
blmm	å¯§ å¯œ
blmq	é¸‹
bldr	å®¿
blnn	ç”¯
blld	ç˜Š
blgn	ç—›
blgs	ç™ˆ
blkb	å¯µ
blkl	ç™”
blkz	ç˜´
blks	å¯´
blkr	ç˜–
blhf	ç—‚
blhr	ç˜¸
blxv	å¯‘
blzv	å®±
blwn	é¹¤ å¯¯
blwq	é¶´ ç™„
bgmv	ç˜•
bgnp	ç—«
bggs	ç™œ
bgxd	ç˜¬
bgyb	ç™€
bkmb	è³“ é¡®
bkfb	ç™© ç˜¶
bkfm	ç–´
bkfd	ç˜Œ
bkft	å¯Œ å†¨
bkfk	ç—˜
bkfr	ç™
bkfw	ç˜·
bkdt	ç˜—
bkgr	ç—
bkkc	å†¡
bkhk	ç—–
bkhv	å†£
bkqg	ç—¡
bkxh	ç—§
bkxz	å¯
bkxv	å¯–
bkzb	é¡
bkzp	çš¸
bkzq	é¶¤
bkzz	é‹
bkzv	é„†
bkcl	ç™‹
bkck	ç˜‚
bksk	ç—™
bkrt	ç˜
bkrl	å¯­ ç˜±
bkrk	å®£
bkrx	ç¿§
bkyb	å¯…
bkyt	å®¤ ç—“
bkyg	æˆ­
bhbb	è³½
bhbp	å¯¨
bhbm	éª
bhbd	è¤°
bhbt	å¡
bhbn	æ´ ğ¬¸£
bhbg	å¼¿
bhbj	å¯‹
bhbq	é¨« é¶±
bhbz	è¹‡
bhbr	èµ›
bhbv	å¯’
bhbw	è¬‡
bhpb	ç© ç™ª
bhpd	ç—¢
bhpt	ç—œ
bhpn	ç—µ
bhpx	ç—¿
bhpr	é¢–
bhmb	å¯Š
bhml	ç˜ª ç˜œ
bhmc	ç™Ÿ
bhdb	ç†²
bhdp	å®·
bhdd	å®¨
bhdt	å¯©
bhds	è¦¾
bhdr	é¢
bhts	å®ª
bhls	ç–©
bhgg	ç–º
bhhh	ç™†
bhjd	å†œ
bhrb	å†Ÿ
bhys	ç˜¢
bjmd	ç˜“ å¯
bjmr	ç™
bjmv	ç˜¦
bjnd	ç—ª
bjlb	å¯¦
bjgd	å‰œ
bjgn	é¹“
bjgl	æƒŒ
bjgg	ç—‘
bjgj	å®›
bjgq	éµ·
bjkn	ç™£
bjqd	ç˜‰
bjqn	ç™¬
bjql	ç™’
bjcw	ç™š
bjsq	å¯« å†©
bjvx	å¯Ÿ ç˜µ
bjyb	é­Œ
bjyn	é­‘
bjyg	é­ƒ é­
bjyk	é­–
bjyh	é­
bjyj	é­
bjyq	é­ˆ é­€ é­† é­Š é­•
bjyx	é¬¿ é­’
bjys	é­ é¬½ é­“
bjyr	é­‰
bjyv	é¬¾
bjyw	é­… é­‹
bqbg	å® 
bqmh	ç–¨
bqjg	ç–£ ç—
bqcd	ç™‘
bqyx	ç¿
bxmt	ç™…
bxfj	å®§
bxdb	é 
bxnq	é´³
bxlf	ç—¦
bxhf	å®­
bxjd	ç—®
bxjg	ç–·
bxjr	ç—»
bxxs	å¯¥ ç˜³
bxvx	ç˜­
bzmv	ç—„
bzdb	ç™² æ¬µ é¡
bzdf	ç—´
bzdn	è‚„
bzdj	è§º
bzdz	ç–‘
bzdr	ç™«
bzhq	å¯ª
bzjd	ç™¤
bzjg	ç——
bzrd	ç—¸
bcbh	ç—¨
bcmb	è²§
bcmg	å¯¬
bcms	å¯›
bcfb	å…º
bcfy	èš 
bcdb	é ’
bcdr	é¢
bcnq	é³»
bcnr	è´«
bclh	ç–¬
bclq	å®¬
bckj	ç–¶
bckv	ç˜½
bckw	ç™±
bchm	ç™§
bcjf	ç˜©
bcsf	ç˜”
bcsj	ç˜
bcrd	å¯ ç˜¼
bcrn	ç™˜
bcrr	å†ª
bcvd	å®¸
bsmf	å®³
bsmd	å‰² ç˜ˆ
bsml	æ†² ç˜›
bsmg	è±
bsmq	é§‚ é¶·
bsms	æ²Š
bsfw	ç™°
bsdp	å¯±
bsdf	å¯¤
bsdn	å¯
bsdv	å¯¢
bsdw	å¯ å¯£
bsnq	é´† é´‡
bshk	åŒ˜
bsqn	å®¯ ç—š
bsqr	ç˜
bsxv	å¯‚
bsrq	ç˜ 
brfx	å¯  ç˜»
brdr	å¹‚
brnq	é´²
brlj	ç–®
brlx	é¼†
brls	è¦­
brlv	é„
brkv	ç˜
brxf	ç˜¡
brsv	ç—¬
brrt	ç—¤
bvdh	å®»
bvlw	ç˜«
bvgy	ç˜™
bvkm	ç—¾
bvjl	ç˜¾
bvxb	è³¨ é ´
bvxk	ç—‰
bvxh	å´ˆ
bvxq	é¶
bvxr	é¢•
bvzl	ç™®
bvsp	å¯‡ å†¦
bvsq	éµ
bvsx	å®¼
bvsc	å† 
bvry	ç™Š
bvvr	ç™
bvvy	ç™‡
bvwv	ç™ƒ
bwfb	é¡
bwfl	æ„™
bwfj	é„¨
bwfz	è¹©
bwfr	é¢
bwfy	èŸ
bwdb	æ–ƒ
bwdv	ç™ 
bwnq	é·©
bwnx	é¼ˆ
bwhp	ç™›
bwhk	é¾
bwhx	ç™
bwjb	å¯³
bwjk	é³–
bwjq	é±‰
bwzb	å¯¶
bwzh	å¯š
bwrs	ç˜
bwvw	ç™•
bwww	ç™
bwyn	ç™´
bwyr	ç— ç™µ
bybw	ç— 
bymj	çˆ¸
bydb	é Œ
byds	ç˜†
bydr	é¢‚
bylw	ç™¨
bygk	é‡œ
bygx	æ–§
bykv	çˆº
byjg	çˆ¹
byxb	é¡ˆ
byxn	é¹Ÿ
byxh	å‹œ
byxq	é¶²
byxx	ç¿
bysq	æ¯¤
bysv	ç˜‡
byys	ç˜®
pbbp	æ£
pbbt	æ¢
pbbk	æ¤Œ
pbbh	æ¨’
pbbr	æ¥·
pbbv	æ¦¨
pbby	æ«
pbmb	æ§‡
pbdm	æ§£
pbns	æ¤¬
pblm	æª¸
pbln	æ©£
pblr	æ¨
pblw	æ¦·
pbkb	æª³
pbkm	æŸ 
pbkt	æ¦
pbkk	æ¥¦
pbkj	æ
pbkz	æ¥ çš¹
pbkc	æ¦¢
pbjj	æ¤€
pbjx	æª«
pbjs	æ«†
pbjy	æ§
pbqb	æ§Ÿ
pbzd	æ§‰
pbcp	æ¤•
pbsl	æ«¶
pbrl	æ¦ 
pbvx	æ£•
pbvs	æ¢¡
pbwf	æ¥
pbyl	æ£‡
ppbt	æ£¾
ppbc	æ£¼
pppz	æªš
ppdb	æ«‡
ppty	æª’
pplz	æ¥š
ppgg	æ¤˜
ppkv	æ¨·
ppjg	æ¢¦
ppcd	è¾³
pprl	æ£½
pprk	æ¥‚
ppvx	ç¦
pmbx	æ«» æ©´
pmmv	æ¬”
pmmw	æ¬‹
pmfy	é¿
pmtg	æª¡
pmkd	æªˆ
pmjl	æª™
pmjg	æ¤¤
pmcq	æª…
pmyw	æ¬
pfms	æ§»
pffb	æ«•
pffp	æ©¾
pffm	æ¢™
pfff	æ¦€ æ¥
pffl	æ§µ
pffs	æ¨¿
pffw	æ¬•
pfkh	æ¥«
pfkj	æµ
pfkq	æª
pfzm	æª¹
pfzj	æ¤¸
pfsb	æ¨»
pfrv	æ£œ
pfyy	è™
pdpm	æ©‰
pdpx	æ¥¼
pdmb	é —
pdmf	æ¡®
pdmg	æ¯
pdmk	æŸ¸
pdms	æ ¤
pdmr	æ©§
pdmw	æ¦
pdfh	æ¤¦
pdfj	æ£¬
pddx	æ©‘
pddz	æª¤
pdtt	æ¥
pdnr	é¢‡
pdnv	æ ­
pdnw	æ«Œ
pdgm	æ ¦
pdgh	æ¢¯
pdkm	æ¤… æ¤¼ æ¦
pdkf	æ©
pdkd	æ š æ¤¾
pdkn	æ ·
pdkk	æ§ æ¤ª
pdkh	æ§
pdkj	æª¶
pdkz	æª–
pdxd	æ©‚
pdxc	æ¨½
pdxv	æ¥¢
pdcd	æ¤“
pdsz	æ¢¿
pdss	æ§˜
pdrz	æ¨…
pdrs	æ¤«
pdvm	æ¡
pdvg	æ§¬
pdvj	æ¡
pdwb	æª¨
pdwq	æ¦š æª¥
pdws	æ¨£
ptbw	æ£± æ§¸
ptfd	æ¦¬
ptdz	æ©½
pttt	æ«‘
pttx	æ¬™
ptts	æ©ˆ
ptkd	æ¤³
pthy	æ¥“
ptjv	æ¦¸
ptzq	æ¨¾
ptrq	æ¥
ptym	æ¦¼
ptyx	æ¨
pnpk	æ¢±
pnfd	æ¬œ
pndk	æ ¶
pndh	æ£¡
pndj	æ£¢
pntf	æ¤†
pnnk	æ …
pngb	æ¤£
pnkg	æ¡º
pnkk	æ§¶ æª²
pnhk	æ£
pnsb	æ¤‡
pnsg	æ¢‚
pnsk	æŸ¶ æ£
pnrm	æ¦²
pnrx	æ¨±
pnvm	æ¥¹
pnwk	æ¤¢
plbf	æ¦œ
plbs	æ¡¦
plbr	æ¥´
plmb	æ©®
plmt	æ¨¤
plmk	æ¥µ
plmq	æ¨‡
plfp	æ¤º
pldm	æ¦Œ
pltt	æ©»
plnf	æ¨€
plnx	æ§‚
plnv	æ¢›
pllw	æ«¦
plgp	æ¥™ æ¥º
plgm	æ¼
plgf	æ©˜
plgd	æ¥‘
plgt	å£„ æ«ˆ
plgn	æ¡¶
plgl	æ‡‹
plgk	æ©™
plgq	æ¢»
plgx	æ«²
plgz	æ¨‹
plgc	æŸ•
plgs	æ©ƒ
plkb	æ«³
plkp	æ¦‡
plkf	æŸŒ æ£“
plkl	æª
plkj	æ§
plkq	æ¨´
plkx	æ¤„
plkz	æ¨Ÿ
plks	æ¨ˆ æ«¬
plkv	æ©¦
plkw	æ©„
plky	æ¥©
plhf	æ·
plhd	æŸ³
plhh	æ ›
plhz	æ £
plzq	æ¥ˆ
plcs	æ¥Œ
plsm	æ¤²
plvs	æ¤‚
plwn	æ§œ æª‡
plwq	æ¨µ
plws	æ¦«
plwv	æ¬†
plyg	æ °
pgmn	æ¨¨
pgmg	æ›
pgmv	æ¤µ
pgmy	æ¬˜
pgfz	æª›
pgdd	æ¦’
pgnf	æ¦ˆ
pglf	æ¢®
pgln	æ¨¼
pglc	æ¤¨
pgls	æ  æ« 
pggb	æ«
pggf	æ¤–
pggd	æ¦
pggj	æ§´
pggq	æ£™
pggc	æ¥„
pgkt	æ¥ƒ
pgkj	æ¢” æ € æ ƒ
pgkz	æª‹
pght	æ¦¹
pghg	æ¦³
pgjv	æ¦”
pgjy	æ¨ƒ
pgqw	æ©µ
pgxb	æ«
pgxp	æ¤
pgxm	æ§¦
pgxf	æ¦¶
pgxl	æƒ
pgxs	æ§º
pgxr	çš™ æ™³ æ¤©
pgxy	èœ¤
pgzq	é¶
pgzc	æ«¥
pgcq	æ¨œ
pgsm	æ¥¯
pgsf	æ¤
pgsq	æ¦
pgsr	ğ¬ƒŠ
pgyb	æ¨ª
pgyq	æ¢¶
pkby	æª·
pkmp	æ¥
pkfb	æ¨• æ«´
pkfp	æ¢€
pkfm	æŸ¯
pkfd	æ¥‹
pkft	æ¥…
pkfk	æ¢ª
pkfj	æ«ƒ æ¨ æ¦§
pkfq	æ£«
pkdp	æ¢¾
pkdd	ğ¬‚©
pkds	æ°
pktk	æ©¿
pknp	æ œ
pknl	æ¬
pknj	æ¶
pknq	æ¢°
pkgj	æŸœ
pkgr	æ¡‹
pkhk	æ¡ 
pkhh	æ¬‡
pkhr	æ¦—
pkhv	æ¤° æ£·
pkhw	æª‰
pkjg	æ™
pkjk	æ‘
pkjj	æŸ©
pkqc	æ¦‘
pkqr	æ§½
pkxg	æ »
pkxh	æ¡«
pkxx	æ£²
pkzz	æ§¤
pkcp	æ¨‘
pkck	æ¤
pksk	æ¡±
pkrp	æ£Ÿ æ£¶
pkrl	æ©
pkrk	æ¡“
pkrj	æ¤»
pkrc	æ§«
pkrr	æ¢œ
pkry	æ¢—
pkvg	æ¨²
pkwj	æ¡†
pkyd	æ¤¡
pkyt	æ¡
pkyj	æ¢
pkyr	æ¨‰
phbc	æ¢¤
phpd	æ¢¸
phph	æ¥¸
phps	ã°€
phpr	æ¥¿
phmb	æ¥¨
phmf	æ«‹
phms	æ©°
phfn	æ¥€
phdd	æ¡ƒ
phdt	æ©
phdv	æ¤¯
phtb	æ¬‘
phtm	æ«¨
phtf	æ¢
phtl	æ«–
phnt	æ§‹
phnl	æ¨¬
phnk	æ¨ æ«·
phns	æ¨
phnr	æ¡¢
phlf	æ¬ˆ
phls	æ 
phlw	æ§¯
phgg	æŸ‰
phgv	æ¥¡
phkf	æ¨¸
phkk	æ¦¿
phkv	æ¬‰
phkw	æª
phhf	æª† æ«¿
phht	æ©©
phhh	æ©¯
phjh	æŸ¹
phqc	æ¦­
phzg	æ¢ƒ
phsf	æ 
phsk	æ£°
phrb	æ¢
phrp	æ§• æªª æ«Ÿ
phrl	æ¢£
phrq	æ¢
phrs	æ§ª æ§” æ¥¾ æ§¹ æ©·
phrr	æ£‰
phrw	æª„ æ¥»
phvz	æ§Œ
phwy	æ¦©
pjmj	æ ¬
pjmr	æªœ
pjfd	æ¤§
pjft	æ¬ƒ
pjfr	æª¢ æ¤œ
pjfy	èš»
pjnc	æ£†
pjlb	æ¨Œ
pjlg	æ ‚
pjlc	æ¤½
pjly	æ¬š
pjgp	æ¦¤
pjgm	æ¡
pjgd	æ 
pjgg	æ ˜
pjgs	æ¦Š
pjgv	æ¡
pjkn	æ«¸ æ¬…
pjks	æ¤´
pjkr	æ©¹
pjqp	æ«¯
pjqd	æ¦†
pjqk	æ«­
pjqs	æ¦‚
pjqr	æ«“
pjxm	æ£¦
pjxs	æª“
pjcn	æª
pjcj	æ¡…
pjcw	æª
pjsk	æ£€
pjsr	æ§ 
pjvq	æ©ª
pjvs	æ§²
pjyx	ç´®
pqbg	æ Š
pqmm	æ£©
pqmn	æ «
pqmh	æ’
pqff	æ§—
pqxq	æ¥•
pqcp	æ¬
pqcd	æª‚
pqsr	æ©¬
pqvg	æŸ­
pxbv	æ¢«
pxmb	æªŸ
pxmm	æ©š
pxmt	æ©Š
pxms	æ££
pxfk	æ«®
pxdz	æ«
pxng	æ¥—
pxnr	æ§š
pxlf	æ¢§
pxkb	æ§“
pxkv	æ¡
pxhf	æ¡¾
pxjf	æ¡°
pxjd	æ£–
pxjg	æŸ¢
pxjr	æ£”
pxxx	æ¦‹
pxxc	æ¨³
pxxs	æ¨›
pxxr	æ§¢
pxxw	æ«‚
pxvd	æª¦
pxvq	æ§±
pxvx	æ¨™
pzbm	æ©“
pzmb	æ«
pzmv	æŸ
pzff	æ©²
pzft	æª¯
pzfc	æ¨¹
pzdf	æ¤¥
pzdd	æ«¤
pzdj	æŸ‚
pznw	æ ´
pzln	æ¡´
pzlg	æ¢´
pzlc	æª®
pzlw	æ¨©
pzgv	æ¥¥
pzhs	é¬±
pzjd	æ«›
pzjg	æ¢…
pzxl	æª¼
pzzh	æ¦£
pzzx	æ«¾
pzcb	æª±
pzsq	æ©…
pzsr	æ© æ«¡
pzrw	æ¤±
pzwt	æ¨¦
pzyd	æ¦½
pcbc	æª¬
pcmq	æ«—
pcfq	æ¤·
pcfs	æ¬Ÿ
pcfw	æ¬Š
pcnb	æ©›
pcnd	æ¥§
pclb	æ¤›
pclh	æ¥
pclj	æ™ æ¬
pclq	æ«µ
pclv	æª´
pckb	æ©«
pckp	æ¥ª
pckg	æ¨ 
pckh	æ¦µ
pckj	æ» æ«™
pckz	æ«£
pckc	æ©± æ¬‚
pcks	æ¨º
pckv	æ§¿
pchm	æ«ª
pchx	æ¦
pcjf	æ¦™
pcjx	æ«’
pcqf	æ¥‰
pcxm	æ«¹
pcxq	æ¥²
pczc	æ«‰
pccn	æ«”
pccq	æ¬Œ
pcsb	æ£‹
pcsf	æ¥›
pcst	æ¨­
pcsl	æª§
pcsj	æ¤¹
pcsq	æ§­
pcsx	æ«€
pcsr	æ§†
pcrd	æ¨¡
pcry	æ©—
pcvp	æ¥³ æ¬—
pcvd	æ¡­
pcvc	æ§ˆ
pcwm	æ¨¥
psbn	æ¡²
psmd	æ¥”
psml	æ«˜
psmx	æ§¥
psfp	æ©–
psft	æª” æ¨˜
psfh	æ©•
psfq	æ¬“
psfx	æ©­
psfs	ğ£—‹
psfy	æ¥œ
psdp	æ¤ˆ é¾¾
psdh	æ¨¯
psdz	æ¢‰
psng	æ¥ 
psns	æ¤
psld	æ¤Ÿ
pskn	æ¦‰
psks	æ¡„
pshh	æ¢‘
pshc	æ¢¼
pshv	æ¢†
psjg	æ¡š
psqk	æ¾
psqj	æ ²
psqr	æ¥®
psxv	æ¤’
pszg	æ©¶ æªŠ
pscb	æ©¨
psrp	æ¦› æ¨”
psrd	æ¥±
psrn	æ£’
psrh	æª£
psrj	æ¨
psrr	æ¤¿
psvl	æ¥¤
prbb	æ£
prmd	å€
prms	æ¡¼
prmv	æ§¾
prfx	æ¨“
prfw	æ«¢
prtc	æ¦¯
prlf	æ¢’
prll	æ£¯
prlg	æŸƒ
prlj	æª
prkp	çš¶
prkq	é¸‰
prkc	æ£
prkv	æ¥Š æ¨¶
prxf	æ§
prxx	æ¦»
prsj	æ¥¬
prss	æ¦¥
prrt	æ¡½
prrq	æ«¼
prrr	æ©¸
prvy	æ¡§
prwn	æª
pvmb	æ¨
pvms	æŸ¡
pvkp	æ¨„
pvkc	æ©¼
pvqq	æ©¢ æ¤­
pvxb	æ­€
pvxs	éš¸
pvzm	æ§›
pvzj	æ¦„
pvvp	æ¬„ æ§¡
pvvf	æ«š æ«Š
pvvj	æ«©
pvvr	æ©º
pvvv	æ£³
pvvw	æ©
pvvy	æ©Œ
pvyx	æ¦¡
pwbm	æ¥Ÿ
pwbc	æªº
pwmd	æ«°
pwfd	æ¬€
pwdv	æ«…
pwnf	æ§
pwlm	æ¢ˆ
pwln	æ¤
pwlv	æ§¨
pwlw	æ£­ æ©”
pwhp	æª
pwhk	æª€
pwhx	æª©
pwjd	æ© 
pwqm	æ ™
pwsm	æ¡»
pwsz	æ§°
pwsr	æ«§
pwrd	æ¦±
pwrs	æ¤Š
pwym	æ©€
pwyt	æ§’
pwyn	æ¨†
pwyh	æ¢³
pwyq	æ£›
pwyr	æ ¸
pybw	æ¢­
pyps	æ¦ æ¨§
pymq	æ«„
pyff	æ©‹ æ«º
pyfk	æ¬
pydh	æ©³
pyds	æ¡³ æ¤®
pydv	æ£´ æª½
pynw	æ¤¶
pylh	æŸª
pygg	æ£§
pygy	æ¬›
pykj	æ¢¬
pyks	æ¡¡
pyhn	æ¡™
pyqq	æ©‡
pyqr	æ¡¸
pyxp	æ£…
pyzm	æª»
pyzs	æ¬–
pysc	æ«
pysr	æª°
pyvt	æ¨«
pyvj	æ¨—
pyvy	æ©’
pyyp	æ£¥
pyyf	ç¤¬
pyyd	æ¨Š
pyyn	æ”€
pyyh	ç‡“
pyyj	æªµ é¢
pyyq	æ©Ÿ
pyyc	æ¬ æ¬
pyys	æ§® é¬°
pyyy	è œ
mbbp	è³
mbbm	è²¯
mbbx	è³©
mbbz	è³±
mbmb	è²² è³ è´”
mbmh	ç½Œ
mbmj	é‘
mbmq	é¸š é¸
mbmx	å¬°
mbmw	ç”– è­» è´
mbfm	è³—
mbff	å•™
mbfl	è´ƒ
mbdm	è³¹
mbdf	ç ¦
mbdk	è³†
mbdh	è³º
mbdj	è²¤
mbdr	è´ˆ
mbtq	è³³
mbnb	è³Ÿ
mbnm	è³µ
mbnf	è³™
mbng	è³•
mbnq	é´œ éµ™
mbnr	èµ€
mblb	è´š
mblm	çŸƒ
mblf	è³ 
mblw	é›Œ
mbly	è³‹
mbgt	è³
mbgg	è³˜
mbkb	çš çŸ‰
mbkm	çœ
mbkk	ç»
mbkj	ç›»
mbkq	è³Š
mbkz	ç´
mbkc	è³»
mbky	è ˆ
mbhm	è³‰
mbhf	è²¼ è´Œ
mbht	è³¼
mbhg	è²¶
mbhh	è³§
mbhv	è²¹
mbjp	è³–
mbjk	ğ«š–
mbjj	ç•
mbjq	é®†
mbjw	è´
mbqq	è³„ è´†
mbxm	è´
mbxd	è³¬
mbxg	è²¾
mbxz	è´‰
mbxs	è³¿
mbzb	è´–
mbcd	è³‘
mbcn	è´
mbcq	è´“ è´œ
mbsb	è´˜
mbsf	ç
mbsn	è³¯
mbsq	è³
mbsr	è³­ è³°
mbrf	è³¶
mbrn	æ­¶
mbrl	ç‘
mbrg	é£º
mbrx	è³’
mbrv	è³œ
mbvg	è³¦
mbvx	ç¥¡ éª”
mbvs	ç† è²¦
mbwf	è³‚
mbwt	è²¥
mbws	è³¥
mbwr	è³…
mbyf	è²½
mbyg	è³¤ æˆ
mbyx	ç´« çˆ
mbys	è´‚
mbyw	è³
mmbk	ç¾
mmbq	é·ª é·¶
mmmd	å¥°
mmnq	é¶¥
mmlg	æˆµ
mmlq	æ° é¸œ
mmlv	çŸ ğ¨Ÿ 
mmlw	ç¿
mmhb	é » é¢¦ é¡°
mmhh	æ­¥
mmhr	é¢‘
mmvg	éª¥
mmvz	é
mmvv	çœ”
mfms	ç¡
mffp	çŸ‚
mffl	ç£
mfsb	ç¶
mfsr	ç†
mdpm	çµ ğ¬´Š
mdpn	æ­¯
mdpg	é½¢
mdpx	ä–
mdpz	ç‡
mdmb	é ‰
mdmg	ç½˜
mdmk	ğ¬³µ
mdmr	ç½¾
mdfj	ç 
mddx	ç­
mdtt	ç³
mdns	éºº
mdgh	ç‡ ç½¤
mdkm	éª‘
mdkd	çœ¹
mdkn	çœ»
mdhw	çŸ€
mdrj	ç½¨
mdrz	ç›
mtbt	ç¦
mtbw	ç–
mtfd	ç
mtfq	çµ
mtdb	æ­
mtdg	çª
mtdq	é¸…
mtdw	æ–
mttg	ç½«
mtqb	é»·
mtqm	é»¸
mtqf	é» é» 
mtqd	é»©
mtqt	å¢¨ é»«
mtqn	é»­
mtql	é»”
mtqg	é»Ÿ é»“ é»£
mtqh	é»
mtqj	é»¥ é»— é»¤ é»¦ é»®
mtqq	é»˜ é»¬
mtqz	é»°
mtqc	é»œ
mtqs	é»ª é»• é»– é»²
mtqr	é»¯
mtqv	é»š
mtqw	é»¢ é»µ
mtym	çŒ
mtyq	ç½´
mtyx	éª¡
mnpk	ç
mndk	éªƒ
mntf	ç­
mngb	ç“
mnsk	é©·
mlbs	éª…
mlnk	å‡¹
mlns	å…•
mlld	çº
mlgf	ç²
mlgd	ç½ éª™
mlgk	çª
mlgc	ç½
mlkb	çŸ“
mlkz	ç•
mlkr	ç½¯
mlkv	ç³ ç½¿
mlkw	ç°
mlrr	çœ¾
mlvs	ç© ğ«˜§
mlwq	ç§
mgmq	ç¾ˆ
mgmv	ç±
mgmy	çŸš
mgdm	ç¾‡
mgnq	é³ª
mgld	çœ½
mgln	éª£
mgls	çœ¿
mggb	çŸŒ
mggq	ç™
mggx	éªŸ
mggc	éª—
mghn	ç©
mgxf	çŠ
mgsm	çƒ
mgvc	ç½»
mkmk	å‡¸
mkfd	ç˜
mkfn	é¹®
mkfj	ç˜
mkfq	ç½­
mkfx	ç¿¾
mkfz	é‚„
mkdp	ç
mknl	çŸ–
mkng	éªŠ
mknj	ç›¹
mkgj	æ­«
mkgr	çœ±
mkhc	éª¤
mkhr	é¿ƒ
mkjq	çœ“
mkxz	ç«
mkcn	è±³
mkrp	ç
mkwj	çœ¶
mkyt	çœ°
mkyj	é©± çœ
mhpl	çŸ
mhph	ç…
mhmf	çŸ
mhdd	çœº
mhtm	çŸ‘
mhts	ğ¬³½
mhnl	éª¢
mhnq	ç‹
mhgg	çœ¨
mhkf	ç¨
mhsk	ç¡
mhrf	çŸˆ
mhvx	è¾ª
mjmr	çº
mjmv	ç
mjfb	å·¼
mjfr	ç¼
mjdl	é¼
mjnc	ç”
mjnw	çŸ
mjgf	çœ³
mjgg	çœµ
mjgz	é€»
mjqd	ç®
mjxm	ç
mjcw	ç»
mjsk	éªŒ ç‘
mjsv	éƒ»
mqbb	é©
mqbg	çœ¬
mqbx	é¨Œ
mqbs	é¦¾
mqby	é¨©
mqmg	é©› é©¥
mqmq	é¨³ é©«
mqfm	é¦½
mqfq	é§½
mqfs	é©’
mqfy	é§›
mqdm	é¨ é§² é©
mqdd	é¨š
mqdg	é§„
mqdk	é§¢ é§“
mqdj	é¦³
mqdq	é©£
mqdx	é§¾
mqdr	é©“
mqtl	é¨¦
mqtg	é¾­
mqtq	é©–
mqtx	é¨¾
mqts	é©
mqty	é¢¿
mqnf	é§‰ é¨†
mqnd	é§š
mqng	é¦º é§µ
mqnk	é§Ÿ é§°
mqnq	é¶ª
mqns	é§”
mqlp	é¨¥
mqlm	é¨›
mqlf	é¨¯ é©ˆ
mqld	é§ƒ é§  é¨¤
mqlt	é¨®
mqlz	é¨¿
mqlc	é§™
mqls	é¨„ é©‹
mqlw	é¨…
mqly	é§®
mqgp	é©§
mqgf	é§¶ é¨§
mqgn	é©
mqgg	é¦¿ é§… é§º
mqgx	é¦¸ é¨¸
mqgc	é¨™
mqgv	é¨¢
mqkp	é§· é¨‹
mqkt	é§¤
mqkl	é©ª
mqkh	é§¬
mqkj	é©… é§† é§
mqkq	é§¥ é§´
mqkc	é©Ÿ
mqks	é§
mqkr	é¦· é¨»
mqhm	é©¢
mqhf	é©¨
mqhd	é§£
mqhl	é©„
mqhg	é¨ˆ
mqhk	é©‰
mqhq	é¦² é¨€
mqhs	é§ª é¨¡
mqhr	é¨¬
mqhw	é¨œ é©œ
mqjp	é§¼
mqjd	é¨Ÿ
mqjr	é©— é¨“
mqjv	é¨ª
mqqg	é§€ é§¹
mqxm	é©Œ
mqxt	é©‘
mqxg	é¨ é¾®
mqxx	é©ƒ é¨•
mqxz	é©”
mqxr	é¨½
mqxv	é§¸
mqzp	é©
mqzd	é¨±
mqzg	é§³
mqzj	é§
mqcb	é¨
mqcf	é§‹
mqcq	é© 
mqcx	é¨µ
mqcz	é¨²
mqcs	é©Š
mqcv	é¨¹
mqcw	é©©
mqsf	é¨
mqsl	é¨˜
mqsh	é¨Š é¨¶
mqss	é§« é¨¨
mqsr	é§¨
mqsv	é¦¶
mqrb	é¨‰
mqrp	é¨
mqrf	é¨‡
mqrl	é¨
mqrg	é§– é§»
mqrj	é¨”
mqrx	é¨´
mqrz	é¨ 
mqrs	é§— é©†
mqvy	é¨· é¨’
mqwf	é§±
mqwd	é©¤
mqwt	é§
mqwk	é©™
mqwr	é§­
mqww	é©
mqwy	é¦¼
mqym	é©¦
mqyf	é©• é§˜
mqyd	é¨ƒ
mqyj	é¨
mqys	é¦» é©‚
mqyw	é§¿ é¨£
mqyy	é§
mxbv	éª
mxmb	éª•
mxng	ç·
mxjl	çœ„
mxjg	çœ¡
mxjr	ç§
mxxw	çŸ…
mxvx	çŸ éª 
mzbm	ç¬
mzbw	ç¹
mzff	ç¦
mzln	ç½¦
mzxm	çœ
mzsq	ç´
mzyd	ğ«˜¬
mcbc	çŸ‡
mcpz	ğ¬º“
mcmb	é¾‡ é¡ª
mcmm	çŸ’
mcmd	åŠŒ
mcmq	æ­²
mcmx	ç¿½
mcfz	é¾Š
mcfw	çŸ”
mcdm	ğ¬ºˆ
mctt	çš
mcns	é¾ƒ
mclv	çŸ†
mcgt	é¾Œ
mcgx	é¾‚
mckg	ç
mcks	ç±
mckr	ç’
mchd	ç½½
mchn	é¾‹
mchx	ğ«˜ª
mcjs	ğ« œ
mcqf	ç°
mcxf	é¾‰
mcxq	æ­³
mczl	é¾
mccp	ç¸
mccf	é¾†
mccn	çŸ‹
mcsb	éª
mcss	é¾…
mcrd	ç™
mcrg	é¾„
mcrq	ğ¬¹¼
mcrr	ç¾ƒ
msmm	è±” è±“
msmf	ğ¬´ƒ
msmk	è±
msmh	è±’
msmj	è‰·
msms	æ·¼ æ² è¦
msmv	é…†
msfb	æ­œ
msfp	æ–€
msfd	åŠ…
msft	ç 
msfq	çŸ˜ é¸€
msfs	æ–£
msfy	èœ€
msdp	éº¹
msdf	æ²¯
msdw	è¦¹
msnb	é ®
msng	ç½±
msns	ç½®
msnr	é¢’
mslm	æ²€
msln	è¦
mslw	ç½¹
mskg	æ¿·
mskj	çœ  ç½ 
msqr	ç½² ç¹
mszh	ğ«˜¦
msrp	ç½º
msrr	ç¶
msyy	è¦
mrfx	çœ
mrgs	ç½¼
mrhv	ç²
mrsv	ç—
mrrb	é½œ é½”
mrrm	é½® é½¸
mrrf	é½¬ é½ é½ 
mrrt	é½· ç‰
mrrn	é½’ é½² é½µ
mrrl	é½•
mrrg	é½¡ é½¦
mrrk	é½«
mrrh	é½– é½º
mrrj	é½£ é½“ é½› é½¨ é½¶
mrrq	é½˜ é½¥
mrrx	é½— é½­ é½½
mrrz	é½ª é½ é½³ é½» é½¼
mrrs	é½Ÿ é½™ é½¯ é½´
mrrr	é½°
mrrv	é½š é½±
mrry	é½©
mvbg	å†€
mvbk	ä¸ 
mvbq	èƒŒ
mvbz	è»°
mvbv	é‚¶ é„
mvmb	æ­µ ç”
mvgy	éªš
mvvr	ç·
mvvv	ç½¬
mvvw	ç¤ çŸ™
mvvy	ç¯
mwfd	éª§
mwrs	çŸ
mwwm	é¬¥
mwwg	é¬¨
mwwk	é¬®
mwwx	é¬¬ é¬­
mwwc	é¬ª
mwws	é¬¦ é¬©
mwwr	é¬§
mwww	é¬«
mwyn	ç
mwyx	ç¾‰
mwyr	éª‡
mwyw	ç®
mybw	éª çƒ
mypm	éª¦
mymq	çŸ„
mydb	é ¥
myds	éª–
mylh	çœ‘
mylw	çŸ
mykj	éª‹
myks	éª
myhn	çœ¸
myqb	ç½·
myqq	ç¾†
myqr	ç
mysq	ç¾‚
mysz	é‚ ç¾„
mysr	çŸŠ
mysv	æ­±
mysw	ç¾…
mysy	é¿¡
myyn	å¹½
fbbk	å•Œ
fbbh	å˜§
fbbc	å“›
fbbs	å“”
fbbr	å–ˆ å™¾
fbbv	é¿½
fblm	åš€
fbkm	å’›
fbkk	å–§
fbkz	å–—
fbhd	å“
fbht	å™»
fbhn	å“°
fbhq	å’¤
fbjj	å•˜
fbjx	åš“
fbsf	å—
fbvs	å”
fbwf	å–€
fbyg	å—²
fbyx	å—¡
fppx	å™¤
fpfp	æ§‘
fpgx	å”½
fpsf	å––
fprk	å–³
fmbb	è¹
fmbp	å–
fmbm	è¹¿
fmbh	å‹›
fmbj	å˜´ è¸ 
fmbq	é¶°
fmbx	è¸ª åš¶
fmbs	è·¸
fmbr	å› è¹œ
fmbv	é„–
fmby	èº¥
fmpk	è¹…
fmmb	å˜ª åš¬ è·
fmmh	è¸„
fmmj	è·
fmmz	åšƒ
fmmr	è¸
fmmv	èº©
fmmw	èº£
fmmy	èº…
fmfb	è¹ª
fmfp	èº
fmfz	è¸€
fmdm	è¸¦ è¹¸
fmdf	è·– è¸
fmdn	å™› è·˜
fmdk	è¹‰ è¸« è·°
fmdj	è·¨ è¸¡
fmdx	è¹½
fmdz	è¹¤ åšº è·¶ è¹
fmdc	è¹²
fmdr	è¹­
fmdv	èº‘ è¸¯
fmdw	èº¨
fmtp	è·º
fmtf	åš¸
fmtd	è¸‹
fmtt	è·¬ åšœ è¸›
fmtq	å˜¿
fmtz	èº‚ è·¿
fmtc	è·±
fmts	è¹º
fmtw	è¸œ
fmnp	è·¥
fmng	è¶¿
fmnk	è·š
fmns	è·™
fmlb	èº˜
fmlp	è¹‚
fmlf	è· è¸£ è¹¢ è¹«
fmld	è¶¹
fmlt	è¹“
fmln	è¸Š
fmlk	è¹¬
fmlh	è¸´
fmlx	è· è¸¥
fmlc	è·—
fmls	è¹³
fmlr	è¹„
fmlv	è¹±
fmlw	è¸“
fmly	è·¤
fmgb	è·œ èº“
fmgm	è¸²
fmgf	è¸® è¸ è·¼ è¸»
fmgd	è¹
fmgt	èº” è¹
fmgg	è¸‰
fmgq	è¹ 
fmgz	è¹†
fmgc	è¹ èº•
fmgr	è¸¬ è¸–
fmgv	è¸±
fmkp	è¸ˆ
fmkm	è·’
fmkd	å™®
fmkt	è·® è¸¾
fmkn	è¶¶
fmkl	èº§
fmkk	è¸
fmkh	èº¡
fmkj	è· è¸‚
fmkz	è¸• è¹¥
fmkr	è·  è¹§
fmkv	è¹‘ è¸™
fmky	èº
fmhb	èº¦
fmhp	èº’
fmhf	è·Œ è¹¼ è·•
fmhd	è·³
fmht	è¹¯
fmhn	è¸½
fmhh	è¸¿
fmhx	è¸’
fmhz	è·¹ è¸”
fmhc	èº†
fmhs	è·£
fmhr	èºœ
fmhv	è¸¹
fmhw	èºˆ
fmhy	è¹¦
fmjb	èº€
fmjm	è¸­
fmjf	è·²
fmjd	è¸°
fmjl	è·½
fmjg	è¹´ å•° è·¢ ğ§¿¹
fmjj	è·ª
fmjq	è¹¨
fmjx	è¹¹
fmjc	è¸š
fmqg	è·‹
fmqr	è¹›
fmxg	è¸º
fmxz	èºš
fmxs	è¹˜ è¹®
fmxw	èº
fmzp	è¸©
fmzm	èºŒ
fmzf	è¸Ÿ
fmzd	è¹Š
fmzl	è¶·
fmzg	è¸‡
fmzj	è¹ˆ
fmzc	èºŠ
fmcb	è¹¶ è¸‘
fmcp	è¹€
fmcf	è¹ƒ
fmcg	è¹£
fmcj	è·‡ è¸¸
fmcq	å™¦
fmcc	è¹°
fmcr	èº‡ è¹’ èº¤
fmcw	èºª èº
fmsp	æ§¼ è¸˜
fmsf	è·
fmst	è¹š
fmsn	è¸
fmsl	é¬¹
fmsj	è¹–
fmsq	è¸ƒ è¹
fmsx	å«¢
fmsc	è¸Œ è¹¡
fmss	è·‘
fmsr	è¸³ è¸·
fmsv	è·‚ è¸§
fmsy	èº å™£
fmrp	è¸
fmrf	è¹Œ
fmrn	åš™
fmrl	è¶» è¸—
fmrg	è·‰
fmrj	è·„
fmrq	è·©
fmrx	è¹‹
fmrz	è¸¨ è¸¶
fmrs	è·ˆ è¹•
fmrv	è¸¢ è¸¼
fmvb	è¹Ÿ
fmvp	èº
fmvq	è·µ
fmvx	èºƒ èº¢
fmvw	èº™
fmwm	è·­
fmwf	è·¯
fmwd	èºŸ
fmwt	è·“
fmwn	é¹­
fmwh	è·¡
fmwq	é·º è·»
fmws	è¸¤
fmwv	èº èº‹
fmww	è¹¾
fmyf	è·† è¹»
fmyg	è¸
fmyk	èº–
fmys	è··
fmyv	è¸µ
fmyw	å›‰ è¸†
ffbs	æ–
ffmb	è³›
ffml	æ‚£
ffmj	å”ˆ
ffmq	é§¡
ffmv	é„¼
fffp	å™ª å–¿
ffff	ç¢
fffd	åŠ‹
fffh	å–¦ åµ’
fffq	æ°‰
fffs	å˜½
fffv	é„µ
ffdm	å–Œ
ffdf	å›‚ åš£ åš»
ffds	è¾‡
fftf	å˜¼
fftj	é¼
fftq	ç¸
fftx	é¼‰
ffnz	é»
ffkj	å‘º
ffkz	è¼¦
ffkv	é„»
ffqf	å™¨
ffxf	å™
ffzd	å—¾
ffcw	åš´
ffsb	å˜³
ffsf	å˜‚
ffrd	å›… è¾´
ffrg	æˆ°
ffrq	é·¤
ffrs	å–®
ffrv	å”¹ é„²
ffvb	é¡
ffvd	å¾
ffvn	é¹—
ffvj	å’¢
ffvq	é¶š
ffvz	éŒ
ffvs	è¦¨
ffvr	é¢š
ffvv	é„‚
ffyf	åšš
ffyw	é›–
fdpm	å™’
fdpx	å–½
fdmg	å˜ å¥
fdmk	å‘¸
fdmz	å˜¥
fdmr	å™Œ
fdmw	å—„
fdfj	å•³
fddx	å˜¹
fdtt	å–¹
fdng	å˜ 
fdns	å–•
fdnw	åš˜
fdkm	å—Œ æ—‘
fdkd	å’²
fdkn	å’©
fdkk	å—Ÿ
fdkh	å—›
fdky	å—
fdxc	å™‚
fdcd	å•„
fdsn	å–¯
fdsg	å•­
fdss	å”´
fdsy	å—´
fdrg	å”¥
fdrj	å”µ
fdrc	å˜š
fdrs	å•´
fdvm	å“˜
fdvj	å’µ
ftdg	å•ˆ
ftdj	å“‹
ftdz	å™ 
fttg	å•©
ftts	å˜µ
ftkd	å–‚
fthh	åš‡
ftym	å—‘
fnfd	å›”
fndl	å—¯
fndk	å’½
fntf	å•
fnlk	å•¦
fngb	å”º
fngx	å“³
fnkm	å’‘
fnkk	å˜“
fnhg	å¶
fnhr	å•ª
fncf	å—£
fncx	ç¿¤
fnsk	å‘¬
fnsy	å—¤
fnrh	å‹‹
fnrx	å˜¤
fnrv	éƒ§
fnvs	å”
fnwk	å•¯
flbf	å—™
flbs	å“—
flbr	å•¼
fldj	å’ƒ
flnf	å˜€
flnk	å—°
flnj	å¼
flnv	å“ª
flld	å–‰
flgf	å™Š
flgk	å™”
flgz	å—µ
flkb	åš¨ å™·
flkm	å“¬
flkf	å‘
flkl	å™«
flkq	æ—˜
flkx	å”¼ å™º
flks	åš«
flkr	å–‘
flkv	å™‡
flkw	å™‰
flhf	å’–
flhq	å—‹
flhx	å–º
fljd	åš 
flxh	å’¿
flcs	å–­
flsm	å–¡
flwq	å™ é·•
fgpp	å˜›
fgpf	åš°
fgpn	åš¤
fgpy	åš’
fgmy	å›‘
fgtt	åš¡
fgnw	ã˜
fgld	å“Œ
fglh	å˜
fgls	å’
fggb	åš
fggl	å‘
fggq	å”³
fgkt	å–”
fght	å—
fghn	å˜±
fgjv	å•·
fgxm	å˜ƒ
fgcq	å—»
fgcv	å–¥
fgsf	å•¹
fgrd	å”°
fkpx	å˜™
fkmq	å˜•
fkfb	å—½
fkfm	å‘µ
fkfd	å–‡
fkfk	å“£ å”–
fkfj	å˜”
fkds	å‘¯
fknb	å™¸
fknl	å›‡
fknj	å¨
fknr	å”¡
fkgr	å’¦
fkhl	ğ««‡
fkhk	å“‘
fkhh	å›
fkhq	æˆ¢
fkhv	å—«
fkjt	è™Ÿ
fkjn	é¸®
fkjg	é¥• é£¸
fkjq	é´
fkqg	å“º
fkqr	å˜ˆ
fkxh	å”¦
fkxx	å•›
fkxz	å•‘
fkzg	å—¨
fkzz	å—¹
fkzc	å›€
fkcl	å™
fkck	å•
fkrp	å”»
fkrg	å•¢
fkrk	å’º
fkrj	å’‚
fkrr	å”Š
fkrw	å˜œ
fkry	å“½
fkwj	å“
fkyt	å’¥
fkyj	å‘•
fhpf	å•
fhpd	å”
fhpn	å”€
fhph	å•¾
fhpx	å”©
fhps	åšŸ
fhmn	åšŠ
fhmq	å—…
fhms	å˜·
fhfd	å™³
fhdf	å•±
fhdd	å’·
fhdt	å™ƒ æ—™
fhdn	å‘¼
fhdv	å–˜
fhtb	å›‹
fhtm	åš§
fhtf	å“ 
fhnd	å™¢
fhnq	å“¦
fhlq	å›
fhlw	å—º
fhgv	å–©
fhkf	å™—
fhkg	åš±
fhkc	å™± åš‰
fhhn	å˜‘
fhhk	å˜˜
fhhh	å˜®
fhjg	å“•
fhct	å˜Š
fhck	å™“
fhsf	å’¶
fhsk	å”¾
fhsj	å–¢
fhrp	åš›
fhrd	å–
fhrq	å”£
fhrs	å—¥ å”• å•² å™‘
fhrw	å–¤ å™­
fhyy	å˜£
fjmd	å–š
fjmr	å™²
fjmv	å—–
fjft	åšµ
fjfn	å•½ å—±
fjfx	å™
fjfr	å™
fjnd	å”¤
fjlg	å‘£
fjlc	å–™
fjgg	å“†
fjkb	å‘‰
fjkr	å™œ
fjqd	å–»
fjqg	å™ˆ
fjqs	å˜…
fjqr	åš•
fjxl	å–¼
fjcw	å™¡
fjvm	å˜¢
fjvq	å˜«
fjvs	å˜
fqbg	å’™
fqmh	å‘€
fqnq	éµ‘
fqjg	å“¤
fqqv	å–
fqxk	å’—
fqcd	å™¥
fqsr	å™†
fxbv	å”š
fxmb	å•¸ å˜¨
fxmm	å˜¯
fxng	æ—”
fxlf	å””
fxkb	å—Š
fxkr	å”
fxjg	å‘§
fxxc	å™š
fxxs	å˜ å™¿
fxxw	åš
fxsm	åš
fxvx	å˜Œ
fzbk	å™
fzbv	å—³
fzbw	å™¯
fzmd	å•£
fzmc	åš¼
fzmv	å’‹
fzmw	å›–
fzff	å˜»
fzfs	å˜­
fzdm	æ—–
fzdj	æ–½
fzdz	æ—
fznw	æ—ƒ
fzld	æ—…
fzln	å“¹ æ–¿
fzlg	å”Œ
fzlj	å•‚
fzlq	è†‚
fzlz	éŠ æ—‹
fzlc	åš‹
fzlr	è†
fzgb	æ—
fzgx	æ—‚
fzgv	å–›
fzkr	æ—†
fzhd	æ—
fzht	æ—›
fzhn	åš¹
fzhq	å™…
fzhv	æ—Œ
fzjb	æ—Ÿ
fzjr	æ—
fzxk	å™¬
fzxx	æ—š
fzzd	æ—
fzzn	ğ¬¸¦
fzzh	å—‚
fzzq	é·Ÿ
fzcb	æ——
fzsq	å˜¸ æ—“
fzrg	æ—
fzwk	æ—œ
fzwh	æ—’
fzyd	å—˜
fzyq	æ—„
fcbh	å” 
fcfq	å–Š
fcfw	åš¾
fctt	å•€
fcty	å›ˆ
fcnb	å™˜
fclm	å—¬
fclh	å‘–
fclj	å‘ƒ åš¿
fclv	åš„
fckp	å–‹
fckf	å˜†
fckj	å‘­
fckq	åš¥
fcks	å˜©
fchm	åš¦
fcjp	å›Œ
fcjf	å—’
fcjv	å–±
fcqf	å–
fcxq	å–´
fcsb	å”­
fcsj	å•¿
fcsq	å˜
fcsx	å˜¶
fcrp	å—
fcrd	å—¼
fcrn	å™§
fcrj	å™¶
fcrq	åšˆ
fcry	å›†
fcvp	å›’
fcvc	å—•
fcwf	åš†
fsbn	å“±
fsbx	å—¦
fsbz	åš åš”
fsmb	è²´ å—©
fsmd	å–«
fsmn	å›“
fsml	åš–
fsmx	å˜’ å™„
fsmz	éº
fsft	å™¹ å˜¡
fsfj	å—ˆ
fsfr	åš
fsng	å–ƒ
fsnz	é—
fsnr	è´µ å”¢
fskj	å‘¡
fsks	å’£
fshh	å”™
fshv	é„™ ğ ³
fsqn	å“®
fsqr	å•«
fsqv	å˜Ÿ
fsqw	å˜‹
fszh	å••
fszy	å˜²
fscb	å™´
fscr	å–·
fssg	å™€
fsrp	å—ª
fsrn	å”ª
fsvl	å”¿
fsvz	é£
fsyn	å“…
frfx	å˜
frlb	å—¿
frlf	å”…
frll	å”¸
frlg	å‘¤
frlk	å–…
frlj	å‘›
frgf	å•¥
frgs	å—¶ åš—
frkv	å˜¬ å•º
frjv	ğ«‘¡
frxf	å—†
frsj	å–
frrt	å”‘
frvb	æ—•
frvl	ä¹»
frvy	å“™
frwn	å™™
fvmb	å˜–
fvns	å”¨
fvnr	å•§
fvkm	å•Š
fvks	å“Ÿ
fvvp	å—“
fvvk	å’
fvvj	åšª
fvvv	å•œ
fvwb	åš½
fvyx	å—‰
fwbt	å–¨
fwbc	åš
fwmr	å–’
fwfd	åš·
fwdv	åšŒ
fwnf	å—ƒ
fwlm	å“¼
fwln	å•
fwlw	å™‹
fwhd	è£´
fwrs	å•
fwrw	å›ƒ
fwvw	å™°
fwwl	å™–
fwyh	æ—ˆ
fwyq	å”· å“œ
fwyr	å’³
fwyw	å›„
fybb	èš è¾ è ™
fybf	è›
fybd	è
fybt	èœŒ è²
fybl	èŸ
fybk	è–
fybj	èœ¿
fybx	è›» è‰
fybz	èŠ
fybc	èš¡
fybr	è”
fybw	å”†
fyby	èš£ èš¥ è
fypx	èœ¥
fypy	èœ™
fymb	è›½
fymm	è
fymd	è ‰
fymg	è™² è Œ
fymj	èš† èŸ•
fymq	è åš‘ èŸ”
fymx	è ³
fyms	èœ†
fymv	è ¼
fymw	è ·
fymy	è ‹
fyfm	è ± èš›
fyff	å˜º
fyfd	èœˆ
fyfn	èœ— è£
fyfj	è‡
fyfq	èœ
fyfs	èŸ¬
fyfy	èŸ²
fydb	è¢ è €
fydm	è 
fydf	èŸ®
fydd	è›š è¡
fydt	è°
fydn	è›˜
fydk	èš½ è›¢
fydh	èŠ
fydj	èœ· è™µ
fydq	èŸ»
fydx	èœ• è¼ èŸŸ
fyds	è‰ èœ£ è’
fydr	è›³ è›¨
fydv	åš… è¤
fydy	è†
fytt	è›™ è 
fyth	èœ
fytq	èŸ è ˜
fytx	èº
fytz	èŸ½
fyts	èŸ¯
fynp	èŸ‚
fynm	è
fynf	èœ©
fynt	èšº
fyng	è›·
fynk	èˆ èŸˆ èœ 
fynj	è„
fynx	è …
fyns	è›† èœ–
fynv	èš¦
fynw	èš’
fyny	è›§
fylb	èŸ˜ è ¬
fylp	èš
fylm	èœ¢
fylf	èƒ èª
fyld	èš—
fylt	è©
fyln	è›¹ è™¸ èœ¬
fylg	èš®
fylh	å‘¦ è›œ è› 
fylq	ä—› è‘ èŸ™ èŸ­
fylz	èŸ‘
fylc	èš¹
fylr	è§
fylw	åš¯ èœ¼
fyly	è›Ÿ
fygb	èŸ¥ èš­
fygm	èš“
fygf	è¸ è— èœ›
fygt	è”
fygn	è·
fygg	èš‡ èœ‹
fygh	è Š
fygq	èœ§ è– èŸ…
fygx	èšš
fygz	è
fygc	è™
fygr	èœ¡
fygv	è¦ è‚
fygy	èš è ¾
fykp	è€ èŸ
fykm	èšµ è™°
fykd	è›± è²
fykt	è  è›­
fykn	è™¶ è›ƒ
fykl	èŸª
fykg	èœ… èœ½
fykk	è›µ
fykj	èš· è˜
fykq	èœ®
fykx	è¹ è ®
fykz	è›¼ èœ¨
fyks	å““ èš²
fykr	è¬ ä—– è›¦ è›º
fykw	èŸ¶
fyhb	è•
fyhp	èŸ è ‘
fyhm	è ¦
fyhf	è› è›… è›ˆ è‚ è µ
fyhd	èœŠ
fyht	èŸ 
fyhn	å“ èœ èº
fyhl	èŸ‹ è… èŸŒ
fyhg	èœ“
fyhk	è˜
fyhh	èŸ§
fyhq	è›¾ è™´ è‘
fyhx	èœ²
fyhs	èŒ
fyhr	è„
fyhw	è—
fyjb	èœ
fyjp	èœ
fyjf	è›¤
fyjd	è“ è
fyjn	è 
fyjg	è›¥
fyjj	è›« èœ­
fyjc	èœ¦ è
fyjs	èœº
fyjv	è‹
fyjw	èŸ¾
fyqm	èœµ
fyqg	èš˜ è›‚ è›–
fyqh	èšœ
fyqq	è›•
fyqr	å” è®
fyxm	èŸ°
fyxg	èš³
fyxk	è™¹
fyxj	èš”
fyxx	èµ è›¡
fyxz	èŸ«
fyxc	èŸ³
fyxs	èŸ‰
fyxw	è —
fyzm	åš‚
fyzf	èœ˜ è›£ èŸ¢
fyzd	å”‰ è‡
fyzn	èœ‰
fyzl	è™¼
fyzg	èœ’ ä—´
fyzq	èŸ¡ èŸ±
fyzz	èœ
fyzc	è›¶
fyzs	èŸ› å›•
fyzv	èš± è¯
fyzw	è®
fycb	èœ èŸ èŸ©
fycp	è¶ è¾ è ‚
fycm	è ¨
fycf	è›
fycd	èŸ† èœ„ è§
fycn	èŸ’ è £ èœ¹ è† è ‡ è 
fycg	èŸ
fycj	è› èš…
fycq	è › è›
fycx	èˆ èŸ–
fycc	è “ èŸµ
fycr	è¨ è ´
fycv	èš¶ è – è¼
fycw	è ¸
fysb	èŸ¦
fysp	è“
fysm	èšŒ
fysf	è›„
fysd	èš
fyst	è³ èœ” èŸ·
fysn	èœ¯ è‹
fysg	è» èŸ¤
fysh	èœª
fysq	è›¸
fysx	å™
fysc	åš©
fyss	å–² èš«
fysr	è½ è« èŸ
fysv	å–  èš‘
fysy	è´ è Ÿ
fyrb	è  èœ«
fyrp	èœ¾
fyrm	è¹
fyrf	è›¿ è¥
fyrn	è „
fyrl	èš™
fyrg	è›‰
fyrj	è è¿
fyrq	èš§
fyrx	è»
fyrz	è­
fyrv	èœ´ èª èŸƒ
fyvt	è›
fyvg	è³
fyvq	èœ»
fyvx	è¦
fyvs	èšª èš–
fyvv	èƒ
fywm	èœ‚ è
fywf	è›’
fywd	è °
fywt	è›€ èš¢
fywn	è­ èœ³
fywk	èŸº
fywj	è™»
fywq	è›´ èœŸ è
fywc	è ”
fyws	èŸ€ èœ¶
fywr	è ©
fywv	è 
fywy	èšŠ èš¿
fyyf	èŸœ
fyyn	è›‘
fyyh	èš´
fyyq	å˜° èš èŸ£
fyys	è›² å˜‡
fyyv	è • è©
fyyw	è¬
dbmb	è³‡
dbfp	æ¥¶
dbdp	ç²¢
dbnr	èµ„
dbkb	æ®¯ æ®¥
dbhp	ç§¶
dbhn	ç‰µ
dbqb	æ®¡
dbzz	å‡
dbrl	å‡•
dbrg	é¤ˆ
dbvx	å¾–
dpbb	ç²ƒ
dpbx	ç²½
dpbc	ç²‰ ç³˜
dpby	å‡‡
dppk	ğ¥»—
dppx	å‡š
dpmd	ç³«
dpmj	ç²‘
dpms	ç²¯
dpmr	ç³¬
dpdb	é ª
dpdd	ç³‹
dpdg	ç²
dpdq	ç³•
dpds	ç³†
dpdr	ç²¨
dpdv	ç²« ç³¥
dpdy	ç³
dptg	ç³
dpnk	ç²£ ç³°
dpns	ç²—
dplp	ç³…
dpld	ç³‡
dplt	ç²ˆ
dpln	ç±½
dplk	ç²’
dplq	ç³ˆ
dpls	ç±¸ ç²¶ ç³¡
dpgm	è¡“ ç²Œ
dpgf	ç³–
dpgd	ç³‘
dpgt	ç²§
dpgn	ç³’
dpgg	ç²® ç² ç²
dpgq	ç³
dpgc	ç³„
dpgs	ç³ 
dpgw	ç³¤
dpgy	ç³¨
dpkj	ç²”
dpkc	ç³
dpkr	ç³Ÿ
dpky	ç²³
dphf	ç²˜
dphq	ç³— ç±·
dphz	ç³™
dphs	ç² ç²‹
dphr	ç²•
dpjm	ç²¦
dpjf	ç²­
dpjj	äºƒ
dpjx	æ–­ æ–´ ç¿·
dpjz	é´
dpjr	ç³©
dpjv	é„° ç²¼ ç²´
dpjw	ç”
dpqb	é¡
dpqr	ç³£
dpxd	ç²»
dpxh	ç²†
dpxw	æ•°
dpzf	ç³¦
dpzn	ç²°
dpzl	ç±º
dpzj	ç²š
dpcb	ç²¸ ç³€
dpcp	ç³·
dpcd	ç³¢
dpcn	ç³²
dpcj	ç² ç³‚
dpcz	ç³š
dpcv	ç²“ ç³
dpsp	ç²·
dpst	ç³›
dpsv	ç²…
dpsy	ç³Š
dprp	ç²¿
dprv	ç³§ ç³ƒ
dpvq	ç²¾
dpvs	æ–™
dpvy	ç³”
dpwt	ç²‡
dpws	ç²¹
dpwr	ç³Œ
dpyb	çº‡
dpym	ç³®
dpyq	ç²
dpys	ç³ ç³
dpyr	é¢£
dpyv	ç³¯
dpyw	ç³‰ ç³­
dmbn	é¡¨
dmmm	è¡¢
dmmh	å¾
dmmw	å¤’ å¿‚
dmdq	å¥¡
dmtg	å‡™ æ®¬
dmnl	æ…¿
dmgm	æ­ª ç›ƒ
dmgf	å¦
dmgd	å¥€
dmgn	ç”­ å­¬
dmgk	ä¸•
dmgq	é´€
dmgx	å«‘
dmgz	è¿˜
dmgs	è¦”
dmgv	é‚³
dmjp	æ¡¨
dmjd	å¥–
dmjc	å°†
dmjs	æµ†
dmjv	é…±
dmjy	è€
dmqt	å‡´
dmql	æ†‘
dmzd	è£… å¥¨
dmzv	é†¤
dmcq	å¥¯
dmrx	ä–
dmrv	æœ† é„«
dmrw	ç”‘
dmyg	æˆ›
dfbb	ç ’ ç¤—
dfbf	ç¢¦ ç£
dfbk	ç¢¹ ç¡¿
dfbj	ç¢—
dfbx	ç¢‚
dfbz	ç¤™ ç¢‡
dfbc	ç 
dfbw	ç¢º
dfby	ç¡¡ ç£ˆ
dfpp	ç¢„
dfpk	ç¢´
dfpz	ç¤
dfpy	ç¡¹
dfmb	æ®
dfmn	é½¤
dfmg	ç¤‹
dfmq	ç¢¼ é§¦ ğ¬’”
dfms	æ³µ ç¡¯ ç …
dfmy	ç¤Ÿ ç¤®
dffb	ç£’
dffp	ğ¥–¨
dffj	ğ¥”²
dffs	æ®« ç£¾
dffw	ç¤¹
dfdb	ç¢©
dfdm	ç£· ç¢•
dfdf	ç£Š ç ³ ç£°
dfdd	ç¡º ç¢ ç£¸
dfdl	ç¤ 
dfdg	äƒ ç¤¢
dfdk	ç¢° ç£‹ ç¡‘
dfdh	ç£
dfdj	ç¡½
dfdq	ç¤’
dfdz	ç£« ç¤ˆ é¿
dfds	ç — äƒ…
dfdr	ç¡• ç£³
dfdy	ç£
dftm	ç£•
dftd	ç¢¨
dftt	ç¡… ç¤§
dfth	ç¡³
dftx	ç£¥
dfts	ç£½
dftw	ç¢
dfty	ç  ç œ ç¢¸
dfnb	ç¢˜
dfnf	ç¢‰
dfnn	ç ½
dfng	ç 
dfnk	ç¡± ç¢…
dfnh	ç¢™
dfnz	ç£€
dfns	ç  
dfnr	æ®’
dfnw	ç ƒ
dflb	ç¤²
dflp	ç£¼
dflm	éŸ
dflf	ç£… ç¢š
dfld	ç£™ ç „
dflt	ç£‚
dfln	çŸ· ç¡§
dflk	ç£´ ç ¬
dflh	åŠ¯ åŠµ å‹Œ
dflj	å·
dflq	ç¤
dflx	ç ¾
dfls	ç¢Œ
dflr	ç¢²
dflv	ç €
dflw	ç¢“
dfgb	ç¤¦ ç£º ç¤©
dfgm	ç¢·
dfgf	ç¢¢ ç£„ ç¤³
dfgd	ç¢¾
dfgt	ç£ƒ
dfgl	ç ¨
dfgg	ç¡ ç¡  é£¬
dfgq	ç © ç¢¿ ç£†
dfgx	æ–«
dfgc	ç¢¥
dfgs	ç ¯ ç£¤
dfgr	ç¢
dfgv	ç¢¬
dfgy	ç ¿
dfkp	ç£²
dfkm	çŸ´ ç ¢
dfkd	ç¡ ç¡–
dfkn	æ…
dfkk	ç¤“ ç¡œ
dfkj	ç ¸ ç ˜
dfkz	ç¡¨
dfkc	ç£š è±¢ ç£—
dfks	ç ° çŸ¹
dfkr	ç¡¤ ç£¢ ğ¥•¢
dfky	ç¡¬
dfhb	ç¢µ ç£‡ ç¤¸
dfhp	ç¤«
dfhm	ç¢‹
dfhf	ç § ç¡
dfhd	ç¤‡
dfht	ç£»
dfhn	ç‰¶
dfhl	ç¡¶
dfhg	ç ­ ç¡¸
dfhk	ç¡‡ ç¡µ ç¡¾ ç£‘ ç£ 
dfhh	ç¢³ ç£±
dfhj	ç¡™
dfhq	ç¡ª çŸº
dfhx	ç¤¯
dfhz	ç£“
dfhc	ç£®
dfhs	ç •
dfhr	ç ¶
dfhw	ç£ª ç¤‰ ç¤
dfhy	ç£
dfjb	ç¤–
dfjp	ç£” ç¡¢
dfjm	ç¢€
dfjf	ç¡†
dfjg	çŸ½ ç ª
dfjk	é² ç¡·
dfjj	ç¡Š
dfjq	ç£¶ é®
dfjx	ç£œ
dfjc	ç¢–
dfjs	ç¢«
dfjr	ç¤†
dfqg	ç¡¥
dfqh	ç ‘
dfqc	ç Œ
dfxb	ç¢½
dfxn	ç¡‰
dfxg	ç ¥
dfxk	çŸ¼
dfxh	ç ‚
dfxx	ç£¦
dfxz	ç£¹
dfxs	ç£Ÿ
dfxr	ç¢ˆ ç£–
dfzf	ç¡ˆ ç¤‚
dfzd	ç£
dfzl	çŸ»
dfzg	ç¡Ÿ
dfzh	ç£˜
dfzj	ç ¤
dfzv	ç Ÿ
dfcb	ç¡´
dfcp	ç¢Ÿ
dfcm	ç¤š ç¤° ç¤·
dfcd	ç¢¤
dfcn	ç¤ª
dfch	ç£¡
dfcj	ç º ç¡­ ç ˆ ç¢ª ç¤
dfcq	ç¢± ç£© ç£­ ç¤£
dfcx	ç¤¤
dfcc	ç¤´ ç¤ ç¤¡
dfcw	ç¤¶
dfcy	ç ¹
dfsb	æ®¨
dfsd	ç¢¶
dfst	ç¤‘
dfsn	ç¡£ ç¤ƒ
dfsk	ç¢¯
dfsq	ç¡
dfss	ç ² ç¡„
dfrl	ç ›
dfrg	ç ± é¤‹
dfrk	ç ¼
dfrj	ç¢£
dfrq	ç  ç¤˜
dfrz	ç¢®
dfrc	ç¢
dfrv	ç¢­
dfvb	ç£§
dfvp	ç£‰
dfvf	å”˜
dfvg	ç – ç¢¡ ç¢”
dfvk	ç¡
dfvj	ğ¬’—
dfvq	ç¢ƒ
dfvx	ç¤”
dfvr	ç¢› ç£µ
dfvw	ç£
dfvy	ç¤€
dfwm	ç¢ 
dfwf	ç¡Œ ç¢»
dfwt	ç Š ç «
dfwn	ç¡¦
dfwg	ç ¡
dfwh	ç¡« ç¡›
dfws	ç¢
dfwr	ç¡‹
dfww	ç¤…
dfwy	ç ‡
dfyb	ç¤¥
dfym	ç¤› ç¤µ
dfyf	ç¤„
dfyt	ç¤Œ
dfyg	ç¢Š
dfyh	å‹¬
dfyq	ç£¯ ç¡š
dfyx	çµ­
dfys	ç¢œ ç¡— ç££
dfyv	ç¤
dfyw	ç¤­
dfyy	ç¡¼
ddmf	å™µ
ddmq	é¦˜
ddmz	é“
ddmc	å°
dddm	è¡œ
ddnq	é´·
ddns	å¥¤
ddlh	åŠ½
ddkm	å¾›
ddkn	å¾‰ ç¾
ddkz	å¾“
ddky	é¿
ddjq	é®¤
ddrn	é¹©
ddrj	æ®—
ddrq	é·¯
ddrx	å°
ddrz	é¼
ddrs	æ®š
ddwd	è£‚
dtbw	å‡Œ
dtby	é¿›
dtfq	æ®±
dttm	è¡—
dtts	å¾º
dtkf	å…½
dtvm	è¡•
dndb	é –
dndq	éµ¥
dntf	å‡‹ å¥ å¾Ÿ
dnqm	éµ†
dnsg	æ®
dnsk	å‡…
dnvb	é§
dnvd	è€
dnvn	é¸¸
dnvl	æ§
dnvg	æˆ
dnvh	å‹”
dnvq	é´¯
dnvx	è€
dnvc	è€
dnvs	é¢ é¦ è€ é¤
dnvv	é„¾
dnvw	æ†‚
dnvy	è  
dlbf	å¾¬
dlmk	æ®›
dllq	ç‚º
dlkb	å¾¿
dlkf	æ®•
dlkv	å¾¸
dlhd	å¥…
dlsm	è¡› å¾« è¡
dlsz	èº— èº›
dlsw	è®† è®
dlwt	å¥®
dlwc	å¥ª
dlws	å‡–
dgmm	å·
dgmd	å‰ƒ
dgmn	é¹ˆ å¾²
dgmh	å¼Ÿ
dgmq	éµœ
dgmz	é€’
dgmv	å¾¦
dggc	å¾§
dgsm	å¾ª
dgvm	è¡ è¡–
dkbm	ç›Š
dkbn	é¹¢
dkbq	é·
dkby	è ²
dkmp	å¾š
dkmm	å¾°
dkml	æƒ©
dkfb	æ¬¹
dkfp	å‡ æ•§ æ®
dkfm	å¥‡
dkfd	å‰
dkfg	é¤Š
dkfj	å¥©
dkfq	å…» é¯— éµ¸
dkfv	æ”²
dkdb	é ©
dkdp	å¾•
dkdz	é€
dkdv	éƒ‘
dktk	æ®­
dknb	æ­š ç¾µ
dknm	ç€ ç¾œ
dknf	å–„
dknd	ç¾­
dknt	ç¾ ç¾³
dknn	ç¾´ é½¹
dkng	ç¾š ç¾ ç¾ª
dknk	å·® ç¾Ÿ ç¾¶ ç¾¥ ç¾« é²
dknh	ç¾° åŠ·
dknj	ç¾¯ ç¾“
dknq	ç¾¢ ç¾¬ é®º é´¹ éµ§
dknx	ç¿” ç¾±
dknc	ç¾’
dkns	ç¾ ç¾– ç¾¦
dknr	ç¾  ç¾·
dknv	é„¯ ç¾º
dknw	ç¾§ æ•¾ ç¾» è­±
dkny	å…¿
dkgm	è¡
dkgj	å¥†
dkhk	ä¸¦
dkhr	æ™®
dkhw	å¤”
dkjk	å†±
dkjj	è‰µ
dkqm	å¥«
dkqd	å‰
dkqq	ç…
dkqx	ç¿¦
dkqc	å‰ª
dkxb	æ­‰
dkxn	é¹£
dkxh	å…¼
dkxq	é¶¼
dkxx	å‡„
dkxz	å¾¢
dkxw	ç”‰
dkcq	é¿ª
dkcz	é‚
dkcv	å‰™
dksk	å¾‘ æ®Œ
dkrp	å‡ å¾ 
dkrr	æ®
dkvm	è¡
dkvl	æ„†
dkyn	å­³ é¹š
dkyl	æ…ˆ
dkyj	å¥
dkyq	é¶¿ é·€
dkyw	ç”†
dkyy	å…¹
dhmq	æ® 
dhmw	é»´
dhts	å†¼
dhtw	å¾®
dhlw	å‡—
dhkk	å‡’
dhjp	æ®©
dhjw	é°´
dhrw	å¾¨ å¾¼ å¹‘
dhwl	æ‡²
dhww	å¾µ å¾´ å¾¾
dhyq	å‡
dhyw	å¾½
djmr	å¾»
djfr	æ®®
djdm	è¡¡
djgg	å¥“
djjg	ä¹¸
djqg	æ®§
djxm	å‡€
djsk	æ®“
djvm	éŠœ
dqmh	å†´
dqvm	è¡”
dqvg	å†¹
dqvr	æ®¢
dxbr	å¸°
dxms	æ®”
dxng	å¾¤
dxlm	è¡™
dxlk	é¿‰
dxjg	å¥ƒ å½½
dxjr	æ®™
dxvd	å¥ 
dxvq	çŒ· é··
dxvx	å¾±
dxvz	éµ é’
dxvc	å°Š
dxvv	é„­
dxvy	è ¤
dzbk	æ®ª
dzmb	å‡Ÿ æ®°
dzmm	è¡˜
dzmd	å¾¡
dzmx	ç¦¦
dzln	æ®
dzlv	æ®‡
dzxm	å‡ˆ
dzzh	å¾­
dzrv	æ®¤
dzrw	å¾©
dzvm	è¡ 
dzyd	å¾¯
dcfq	å‡
dcgd	å‰¢ è±–
dcgg	å¾”
dckp	æ®œ
dckv	æ®£
dcsx	å‡˜
dsbf	è¾–
dsml	å¾· å¾³
dsfm	è¡š
dsfh	è¾‘
dsdm	è¾š è¡Ÿ
dsdz	ğ«Ÿ¦
dsdv	ğ¬¨
dstd	è¾•
dsnf	å¾œ
dsnl	æ†„
dsnj	è¾‹
dsnz	é€©
dsns	æ®– å¾
dslp	ğ«“
dslx	è½¹
dsly	è¾ƒ
dsgp	æ¤ 
dsgd	è¾—
dsgt	å ‘
dsgj	éŒ¾
dsgx	æ–©
dsgr	æš‚
dskm	è½²
dskt	è¾ è½¾
dskg	è¾… è½¼
dskj	è¾„ å†º
dsks	ğ«„
dskr	è¾†
dshf	è½¶
dshn	è½·
dshl	è½¨
dshg	è½³
dshy	è¾€
dsjd	è¾“
dsjs	ğ«
dsqs	å¥²
dsqr	å¥¢
dsxj	ğ¬¨‚
dscf	è½º
dscj	è½­
dssf	è½±
dssd	è¾
dsst	è¾
dsss	ğ¨ˆ
dssy	ç¾—
dsrb	è¾Š
dsrp	æ®
dsrm	è¾’
dsrd	å‡‘
dsrs	è½¸
dsvg	è½¬
dsvk	è½»
dsvv	è½° è¾
dswf	è¾‚
dsww	è¾™
dsyq	è½¿
drdr	çš•
drlm	è¡‘
drlg	å†· å½¾
drkc	å¾—
drjd	å‰¦
drjn	é¹Œ
drjq	éµª
drxf	å‡”
drcs	å¿
drsd	å†
drsg	é¤®
drsv	éƒ¸
drrl	æ…«
drrh	è³ ç†§
drrq	æ®²
drrz	å¾
dvmn	é¸»
dvmq	é´´
dvjd	åˆ³
dvjg	ç“ 
dvjq	é´®
dvjx	ç¶”
dvjs	åŒ
dvjv	éƒ€
dvxk	å¾„
dvsm	è¡
dwfd	å¿€
dwdb	ç¾¡
dwgq	ç¾›
dwgs	ç¾•
dwkb	ç¾¨
dwhp	å‡œ
dwhq	ç¾© ç¾²
dwhx	å‡›
dwqf	ç¾®
dwqd	ç¾¹
dwym	è¡’
dwyh	å‹¶
dwyr	å¥’
dwyw	å¾¹
dygg	æ®˜
dysm	è¡
tbbp	å ”
tbbk	åŸª
tbbq	å —
tbbr	å ¦
tbmb	å¡¡
tbdd	å¡š
tbtp	æ§·
tbtt	é¾³
tbtn	æ‘°
tbth	å‹¢ å‹ ç‡…
tbtq	ç†± é©‡ éµ±
tbtz	é€µ
tbtr	æš¬
tbtw	åŸ¶
tbnx	é¼€
tbns	ç•³
tbkm	å¾
tbkk	å¡‡
tbkz	å š
tbkc	å¡œ
tbhq	å
tbjj	ç•¹ åŸ¦
tbjy	å¡Š
tbrl	å¡“
tbvs	å¸
tbyx	å¡•
tmmh	åŸ—
tmtg	å¢¿
tmlk	å‡
tmgm	ç›
tmkm	å ½
tfmb	å¡¤
tffj	å ®
tffs	å¢ 
tffw	å£§
tfnr	åŸ™
tflz	é 
tfkq	éŸ¯
tfhd	è¢
tfsb	å¢¤
tfsz	å£
tfyq	è›“
tdpm	ç–„
tdpx	ğª£»
tdmg	å
tdmk	å¯
tdmr	å¢
tdft	å ˜ ç•»
tdfj	åŸ¢
tdtr	å¢—
tdnd	å §
tdgb	è´„
tdgm	ç›©
tdgd	è¤º
tdgt	å¢Š
tdgn	æ‘¯
tdgl	æ…¹
tdgg	ç“¡
tdgq	é¨º é·™
tdgx	ç¸¶
tdgz	é€¹
tdgs	æ¼
tdgv	å ±
tdgw	åŸ· è¬º
tdgy	èŸ„
tdkm	ç•¸ åŸ¼ å¡§
tdkf	å¢¡
tdkn	åŸ
tdkh	å‡²
tdkz	é”
tdjz	é€‡
tdxc	å¢«
tdsq	è½½
tdrj	åŸ¯
tdrs	ğ«®ƒ
tdvm	å³
tdvj	å®
ttbw	å 
ttmg	å¦
ttfj	éƒŒ
ttdz	å¢¶
tttb	é¡¤
tttp	æ«
tttf	ç¤¨
tttt	å£˜ å£¨
tttk	ç–‰
ttth	ç½
tttq	æ° é¸“
tttx	ç¿¹ çº
tttz	é¶
ttts	ç–Š å ¯ å¢
ttnx	é¼ƒ
ttlh	åŠ¸
ttgq	æˆ´
ttkg	å¥Š
tthy	å ¸
ttct	å ¼
ttcn	çŠ
ttcg	é¤
ttcr	å¹« å¹‡
ttrq	å º
tnbf	åŸ›
tndh	å ˆ
tnsb	åŸ§
tnsk	å Œ
tlbf	å¡
tlfp	å ¢
tldb	é¡‹
tlnf	å¢’ å¢‘
tlld	å  
tlgn	åŸ‡
tlgk	å¢±
tlgs	å¢¢
tlkb	å£ 
tlkf	åŸ¹
tlkz	å¢‡
tlks	å¢ƒ
tlkr	å ·
tlkv	ç–ƒ å¢¥
tlhd	å£Œ
tlhh	å¬²
tlzq	å£»
tlwq	æˆª
tgmn	å¢€
tgms	å¡¨
tgdk	å¡€
tglm	å¿
tggb	å£™
tggc	ğ¡š
tgkf	å¢
tghg	èµ±
tgjv	é¿¾
tgxm	å¢‰
tgxf	å¡˜
tgxs	ğ¡“
tgcq	å¢Œ
tgvc	å¢›
tgyb	å¢´
tkmp	å œ
tkmq	å¢•
tkfm	å·
tkft	å ›
tkfj	å¡¸
tkfq	åŸŸ
tkds	åª
tktk	å£ƒ ç–…
tknj	å‰
tknq	é³³
tkhk	å­ å££
tkjd	ç•
tkjk	å˜
tkqg	åŸ”
tkzq	è¼‰
tkcp	å¢š
tkck	åŸ¡
tkrp	åŸ¬
tkrk	å£
tkrj	å °
tkrc	å¡¼
tkrr	åŸ‰
tkry	åŸ‚
tkyt	å¤
tkyj	ğ«­Ÿ
tkyq	è‡·
tkyr	å¡½
thbm	é¾¼
thfb	é¢¶ é£‹
thfm	é¢¹
thff	é¢± é¢³ é¢« é¢­
thfd	é¢²
thft	é£€ é£…
thfl	é¢¸
thfg	é¢°
thfh	é¢¬ é¢· é£ˆ
thfq	é¢µ é£‡
thfx	é£ƒ é£‰
thfz	é¢´
thfs	é¢© é¢® é£‚
thfv	é¢¼ é¢º
thfy	é¢¨ èµ¨ é¢¾ é£
thdb	é ³
thdd	å—
thdt	å¢¦
thdn	å€
thdv	èµ§
thtm	å£š
thth	èµ«
thnd	å¢º
thnk	å¡·
thlw	å¢”
thgf	èµ¯
thgv	èµ®
thkf	å¢£
thkk	å¡
thkc	å£‰
thhb	èµ¬
thhk	å¢Ÿ
thhr	èµª
thjj	èµ©
thqc	å¡®
thcg	å “
thsk	åŸµ
thsr	èµ­ å¡–
thrl	åŸ
thrw	å‡° å ­ å¢½
thvz	å¡ 
thvs	åŸ 
thwy	è«
thyy	å¡´
tjft	å¢–
tjnc	åŸ¨
tjlg	å¶
tjlz	é€º
tjlc	å Ÿ
tjgg	å‘
tjks	å¡…
tjqd	å ¬
tjxm	åŸ©
tjcj	å
tqbg	å…
tqxq	å ¶
tqvg	åº
tqvr	å¢†
txbr	åŸ½
txbv	åŸ
txms	åŸ­
txjg	å»
txxs	ç– ğª¤—
txsm	å£—
txvq	é…¨
txvx	å¢‚
tzbf	è¶¤
tzmg	èµ´
tzfp	è¶®
tzfm	å¡©
tzfz	è¶—
tzdb	è¶‘
tzdf	è¶¦
tzdd	è¶”
tzdv	è¶¥
tztp	è¶“
tztg	è¶©
tzts	è¶¬
tzns	è¶„
tzld	èµ½
tzln	åº
tzlg	åŸ
tzlk	è¶‡
tzlh	èµ²
tzlq	è¶­
tzlc	ç–‡ å£”
tzls	è¶¢
tzlw	è¶¡
tzgb	è¶ª
tzgq	è¶˜
tzgx	èµ¾
tzgr	è¶
tzkp	è¶š
tzkq	è¶Š
tzkv	è¶£
tzky	è¶°
tzhb	è¶²
tzhf	è¶ƒ è¶ˆ è¶
tzhd	è¶’
tzhh	è¶€
tzhz	è¶ 
tzhr	è¶±
tzjg	ç•® è¶
tzjx	è¶‹ è¶‚
tzxg	è¶†
tzxh	èµ»
tzxj	èµ¿
tzxx	è¶
tzxw	è¶¯
tzzf	è¶Œ
tzcf	è¶…
tzsp	è¶œ
tzsf	è¶Ÿ
tzsd	èµ¹
tzsh	è¶¨
tzsq	è¶™ å¢²
tzrt	è¶–
tzrl	èµº è¶
tzrg	è¶•
tzrz	è¶§
tzrs	è¶
tzrv	å¡²
tzyf	è¶«
tcbh	ğ«­¼
tcmt	å£¥
tcfq	å ¿
tcfw	å£¦
tctm	å£’
tctt	å 
tclb	åŸ–
tclm	å¢­
tclh	åœ
tclq	åŸ
tckp	å 
tcks	å¢·
tckv	å¢
tchm	å£¢
tchx	å¡¬
tcjf	å¡”
tcsh	å¢ˆ
tcsj	å ª
tcsq	å¢„
tcsr	å¢¸
tcrd	å¡»
tcwh	å¡ƒ
tsbs	ç–‚
tsmd	å£Š
tsft	å£‹
tsdh	å¢™
tsdj	é‹†
tsnf	åŸ«
tsns	åŸ´
tskj	åŠ
tsks	å™
tshk	å –
tshc	ç•´
tshv	å¹
tsqr	å µ
tsxk	å ©
tsxv	åŸ±
tszl	å¢˜
tscb	å¢³
tsrn	åŸ²
tsrh	å¢»
tsrq	å¡‰
tsrr	å ¾
trbb	å ’
trmv	å¢
trfx	å¡¿
trtc	å¡’
trll	åŸ
trlg	å½
trkv	å ´ ç•¼
trxx	å¡Œ
trsj	å ¨
trsv	åŸ¸
tryy	å£œ
tvvj	å£›
tvvr	å¢¹
tvvv	ã™ ç•·
tvyx	å¡
twbc	å£•
twmd	å£
twfd	å£¤
twnf	å¡™
twln	åŸ»
twlv	å¢
twlw	å¢©
twhp	å£ˆ
twhd	ç•©
twhg	å¡†
twhk	å£‡
twhq	è£
twqm	é¿
twsm	åŸ„
twsz	å¡³
twrs	åŸ£
twyn	å´
twyg	å£ª
twyq	å ‰
twyr	å“ ç•¡
tybw	åŸˆ ç•¯
tymq	å£
tyfb	å”Ÿ
tyff	å¢§
tydv	å å£–
tytl	é£”
tynb	é£“
tynx	é¼
tynw	å «
tylt	é£—
tylh	åŠ« å³
tylv	é£
tygy	å£©
tyhf	é£
tyhh	é£š
tyjv	é£•
tyzm	å£
tyzd	åŸƒ
tyss	é£‘
tysv	å ¹ ç•½
tyrj	æœ…
tyvy	å¢µ
tyys	å¢‹
nbbp	æ¢
nbbm	æ’º
nbbl	æŒ–
nbbg	æ² æ‘‰ æ”¨
nbbk	æ§
nbbq	æ¬
nbbr	æ©
nbbv	æ¾
nbby	æ”›
nbfk	åœ€
nbdk	åœ™
nbds	æŒ¥
nbtk	å›¶
nbnk	å›§
nbny	æœ™
nblm	æ“°
nblr	æ‘
nblw	æ‰
nbkb	æ“¯
nbkm	æ‹§
nbkk	æ
nbkz	æ®
nbhd	åš¢ æ”
nbhq	æŒ“
nbhz	æ”“
nbjj	æ¥
nbjx	æ“¦
nbqb	æ‘ˆ
nbzz	æ“¬
nbcn	æ°
nbsf	æ³
nbsl	æ”‡
nbvs	æ–
nbwf	æ¢
nbyl	æ´
nprk	æ¸
nmbx	æ”–
nmmh	æ—
nmmv	æ”«
nmfk	åœ
nmtg	æ“‡
nmtk	åœ›
nmty	æ‘†
nmnm	èŠ”
nmkd	æ“
nmkk	åœœ
nmjl	é¼
nmsk	å›¦
nmsy	æ“‰
nmvq	æ¹
nmyb	æ“º
nmyw	æ”
nfmb	æ
nfmk	åœ“
nfmj	æŒ¹
nfms	æ‘«
nffb	æ”…
nffp	æ“
nffd	å›Š
nffz	æ”†
nffs	æ’µ æ’£
nfnk	åœ†
nfnr	æŸ
nfkh	æ–
nfkq	æ“‘
nfzj	æ“
nfsb	æ’Œ
nfsk	åœ– åœš
ndpm	æ’›
ndpx	æ‚
ndpw	æ“
ndmg	æŠ”
ndmk	å›¨ æŠ·
ndfp	æ©
ndfn	æ¼
ndfl	æƒ
ndfk	åœˆ åœ
ndfj	æ²
ndfs	æ¼
ndfy	è ¹
nddx	æ’©
ndnq	é´¦
ndnw	æ“¾
ndlb	æ‹£
ndlg	ã§‘
ndgh	æŒ®
ndkb	æ¬­
ndkm	æ æ¤ æ’¯
ndkd	å‰› æƒ
ndkl	æ©
ndkg	æ”
ndkk	æ“ æ½
ndkh	å²¡ æ›
ndkj	ç½”
ndkv	æ·
ndxc	æ’™
ndxv	æ“² æ‚
ndsn	æ¹
ndsr	æ’¦
ndrj	æ©
ndrz	æ‘
ndrs	æ¸
ndvg	æ‘¦
ndvj	æŒ
ndvx	æº
ntbw	æ•
ntfk	åœ’
ntfq	éµ°
ntfx	ç¿¢
ntfz	é€±
ntfs	å½«
ntfv	éƒ®
ntfw	é›•
ntdk	åœ‰
ntdz	æ’»
nttt	æ”‚
nttg	æ›
ntts	æ’“
ntlq	æ“®
ntkd	æ‹
ntxx	äƒ
ntwf	æ’‚
ntym	æ•
ntyk	åœ”
ntyx	æ‘
nnpk	æ†
nnmk	æ”Œ
nnfd	æ”®
nndl	æ‘
nndh	æ†
nngb	æµ
nnkd	åˆ 
nnkk	æ‘‘
nnsg	æ„
nnrm	æµ
nnrx	æ’„
nnwk	æ´
nlbf	æ’
nlbk	å›®
nlbr	æ¥
nlmk	æ‹¯
nldp	æ”—
nlnm	æ¹
nlnf	æ‘˜
nlnk	å› æ”Ÿ
nlnx	æ
nlnz	æ“¿
nlnv	æŒª
nlgp	æ‰
nlgm	æŠ’
nlgd	æ†
nlgn	æ…
nlgk	æ’œ
nlgs	æ’¥
nlkb	æ”
nlkf	æŠ
nlkx	æ¥
nlks	æ‘¬
nlkr	æ
nlkv	æ’
nlkw	æ’–
nlky	é¿œ
nlhp	æ”ˆ
nlhf	æ‹
nlhh	æ‹¹
nlhq	æš
nlhz	æ‹°
nlzq	æŸ
nlcv	æ‘Œ
nlsk	åœ
nlwn	æº æ“•
nlwq	æ’¨
ngbj	è§
ngbs	è¦¥
ngbw	æ•Ÿ
ngpf	æ” 
ngpn	æ“µ
ngmn	æ‘¨
ngmg	æŠ“
ngfz	æ’¾
ngfy	æ‘¾
ngdd	æ¦
ngdk	æ‘’
ngnf	æ
nglf	æŒ¶
ngld	æŒ€
nglc	æ¬
nggb	æ“´
nggd	æŒ
nggq	æ© æ®
nggx	æ§
nggc	æ™
ngkt	æ¡
nghb	æ“¨
nghf	æ‚
nght	æ‹
ngqw	æ’’
ngxb	æ€
ngxp	æ¢Š
ngxf	å“² æª ç¡©
ngxd	è£š
ngxt	åŸ‘
ngxl	ä¹´ æ‚Š
ngxg	æ‹
ngxh	çƒ²
ngxj	éŠ´
ngxq	ç„
ngxx	å¨
ngxz	é€ è¸…
ngxr	æ¶ æ™¢
ngxw	èª“
ngxy	èœ‡
ngcq	æ‘­
ngsm	æ—
ngsf	æ®
ngyb	æ’—
ngyq	æ¤
nkby	æ“Ÿ
nkmp	æ€
nkmk	å›¸
nkfb	æ‘— æ”‹
nkfp	æ’
nkfm	æŠ²
nkfd	æ¦
nkft	æŠ
nkfg	çˆ´
nkfk	åœ‹
nkfj	æ‘³
nkfq	æ
nkdd	æŒŸ
nkds	æŠ¨ æ­
nknp	æ‹º
nknl	æ”¦
nknk	å›¤
nknj	æ‰½
nkgj	æ‹’
nkgr	æŒ—
nkkj	ã§Ÿ æ““
nkkx	é»½
nkkv	é„³
nkhk	æŒœ
nkhh	æ”
nkhs	æ‘‚
nkhr	æ¢
nkhv	æ‘„ æ¶ æ«
nkjg	ä¸£
nkqg	æ•
nkqk	åœƒ åœ‘
nkqc	æ
nkxg	æ‹­
nkxh	æŒ±
nkxx	æ¿
nkxz	æ·
nkzg	æŸ
nkzx	æ‘²
nkzz	æ‘™
nkcl	æ…
nkck	åœ‚ æ—
nksk	æŒ³
nkrg	æš
nkrk	åœ˜
nkrj	æ 
nkrc	æ‘¶
nkrr	æŒ¾
nkry	æŒ­
nkyd	æ¯
nkyt	æŒƒ
nkyj	æŠ 
nkyr	æ‘¤
nhpk	å›·
nhph	æª
nhpx	æ¼
nhmb	æ
nhmn	æ“¤
nhmq	æ
nhdd	æŒ‘
nhdt	æ’­
nhdk	åœŒ
nhdv	æ£
nhtb	æ”¢
nhtm	æ”
nhtf	æ
nhtl	æ”„
nhth	æ“„
nhtr	æ”’
nhnm	è‰¸ èŒ»
nhnd	æ“™
nhnt	æ†
nhnl	æ‘ 
nhns	æ‘£
nhlf	æ”œ é›Ÿ
nhlh	æŠ› æ³
nhlw	æ‘§
nhgg	æŠ¸
nhkf	æ’²
nhkc	æ“š
nhkw	æ“ˆ
nhhp	æ«± ç³±
nhhf	æ”š
nhhn	å­¼ æ‘¢
nhhh	æ’ˆ
nhhx	è¾¥
nhhy	è ¥
nhzg	æŒº
nhsf	æ‹¬
nhsl	æ‰¸
nhsk	æ¶
nhsj	æ’ æ·
nhrp	æ“½
nhrw	æ˜ æ’½
nhvz	æ¥
nhys	æ¬
njmd	æ›
njmv	æœ
njfd	æµ
njft	æ”™
njfn	æ¿ æœ
njfr	æ’¿
njnd	æ¢
njnk	åœ‡
njnc	æ„
njlb	æ‘œ
njlg	æ‹‡
njlc	æ¾
njlr	æ¼
njly	æ”­
njgp	æ©
njgg	æ‹¸
njgr	æ‹Ÿ
njkn	æ”‘
njkr	æ’¸
njhg	æ‹¨
njqd	æ„
njqs	æ‘¡
njqr	æ“¼
njxm	æŒ£
njxk	æ‘
njcw	æ“”
njsk	æ¡
njvh	æ–
njvq	æ’š
njvx	æ‘–
njyx	ç´¥
njys	æ”ª
nqbb	é´¥
nqbg	æ‹¢
nqmn	æ‹µ
nqmq	é·Œ
nqmv	æ“
nqdq	é¸ƒ
nqld	é´ƒ
nqlg	é´
nqlh	é³¨
nqls	éµ¦
nqlw	éµ»
nqgt	é·ˆ
nqkm	é´š
nqhr	é¶³
nqjp	éµŒ
nqjg	æ‰°
nqjh	æ‹‹
nqjs	é¶ƒ
nqqk	å›¿
nqcb	é¶€
nqcd	æ“ƒ
nqcv	é¸Œ
nqsr	æ’
nqrn	éµ¿
nqrs	é¸”
nqvg	æ‹”
nqvr	æ‘•
nqwf	é´¼
nqwv	é´¤
nqww	é·»
nqyw	éµ”
nxbr	æƒ
nxms	æ¸
nxtk	åœ•
nxng	æµ
nxlf	æ‚
nxlk	åœ„
nxkb	æ‘ƒ
nxhf	æƒ
nxhh	æŒ˜
nxhq	æ¯®
nxjd	æ
nxjg	æŠµ
nxjr	æª
nxxc	æ’
nxxs	æ‘
nxxr	æ‘º
nxxw	æ“¢
nxvx	æ‘½
nzbk	æ’
nzbv	æˆ
nzmx	æ”¥
nzmv	æ‹ƒ
nzfb	æ“·
nzft	æ“¡
nzfr	æ’·
nzdb	æ”§
nzdd	æ“¶
nzdj	æ‹–
nzln	æŠ
nzlg	æŒ»
nzlz	é€°
nzlc	æ“£
nzgn	æº
nzgv	æ´
nzkr	æ“Œ
nzhq	æ’
nzjf	æ’˜
nzjd	æ“³
nzjg	æŒ´
nzxm	æ™
nzzh	æ‘‡
nzsq	æ’«
nzrv	æ‘¥
ncbh	æ
ncfl	æ’¼
ncfy	èŸ—
nctt	æ±
ncnb	æ’…
nclj	æ‰¼
nclv	é¹± æ“­
nckb	æ“¹
nckp	æ²
nckh	æ‘
nckj	æŠ´
ncks	æ’¶
nckw	æ”¤
nchm	æ”Š
nchq	æ£
ncjf	æ­
ncjx	æ”ƒ
ncjw	æ“
ncqf	æ¿
ncxq	æ»
nccp	æ“›
ncsb	æ‘
ncsj	æ•
ncsq	æ‘µ
ncsx	æ’•
ncsr	æ“†
ncrp	æ½
ncrd	æ‘¸
ncrj	æ“–
ncrq	æ“«
ncvd	æŒ¯
ncvc	æ™
nsbn	æŒ¬
nsmd	æ³
nsms	æ’¹
nsft	æ“‹ æ‘š
nsfn	æ’‘
nsfk	å›º
nsfh	æ’
nsfq	æ”©
nsfy	èš©
nsdp	æ¬
nsdc	æ‘ª
nsng	æ‡
nsnh	æŠ
nsnq	æ“œ é´¡
nsny	æ“¸
nslh	åŠ©
nslw	é›
nsgp	çš³
nsgm	ç›š
nsgd	è£˜
nsgl	æ…¦
nsgz	é€‘
nsgw	æ•‘
nskk	å›» æ„
nskj	æŠ¿
nsks	æŒ„
nshv	æŒ·
nsjg	æ‹¶
nsqj	æ‹·
nsxl	æ‡¸
nsxk	æ¯
nsxx	ç¸£
nsxv	æ“
nszg	æ“€ æ’ 
nszh	æ
nssg	æ’°
nsrp	æ¸ æ‘·
nsrd	æ
nsrn	æ§
nsrj	æ‘
nsvl	æ”
nsvk	å›«
nsyl	æ‚¬
nrbb	æ
nrbk	è´®
nrmv	æ‘±
nrfx	æ‘Ÿ
nrfw	æ“»
nrdh	èµš
nrdr	èµ 
nrnm	èµ—
nrnf	èµ’
nrnn	é¹¦
nrng	èµ‡
nrnh	ç½‚
nrnx	å©´
nrnr	èµ‘
nrlf	èµ”
nrld	æ‡
nrll	æ»
nrlg	æ‹
nrlk	å›¹
nrlj	æŠ¢
nrlr	æ‘¿
nrgf	æ¨
nrgt	èµƒ
nrgv	èµ†
nrkg	æ‘
nrkq	è´¼
nrkc	èµ™
nrkv	æš æ’®
nrhf	è´´
nrhg	è´¬
nrhh	èµ•
nrjw	èµ¡
nrqq	è´¿
nrxf	æ¶
nrxx	æ¨
nrcd	èµˆ
nrsb	æ²
nrsd	èµ
nrsj	æ­
nrsr	èµŒ
nrsv	æ¦
nrsy	è´­
nrrt	æŒ«
nrrq	æ”•
nrrx	èµŠ
nrrv	èµ
nrvg	èµ‹
nrvq	è´±
nrwf	èµ‚
nrwn	æ“’
nrwr	èµ…
nrym	æ“
nryf	è´»
nvmg	æˆ¤
nvmh	å‹–
nvmq	æ¯·
nvfn	å†”
nvfy	æ»
nvdk	å›´
nvlw	æ‘Š
nvgy	æ”
nvjg	æŠŸ
nvqk	åœŠ å›²
nvqq	æ’±
nvzj	æ½
nvsg	å»½
nvsk	å›­
nvsz	é€¥
nvvp	æ”” æ¡
nvvf	æ“±
nvvv	æ‡
nvvw	æ’‹
nvvy	æ’Š
nvyk	å›© å›³
nwbm	æ¨
nwmp	æ«œ
nwmr	æ
nwfd	æ”˜
nwfy	è›°
nwdv	æ“ 
nwtk	å›¥
nwnf	æ
nwnq	é´…
nwnr	è´½
nwlh	åŠ¿
nwlw	æ– æ’´
nwgk	å›½
nwhd	è£Š è¢… æŒ”
nwhk	æ“…
nwcv	é›˜
nwsm	æ€
nwsz	æ‘“
nwrs	æ½
nwvk	å›¾
nwvw	æ“
nwyf	æ”
nwyt	æ
nwyn	æ‘› æ’
nwyk	åœ åœ
nwyq	æŒ¤
nwyx	çµ·
nwys	æ‘”
nwyw	æ’¤ æ”¡
nybw	æ˜
nyps	æ‘‹
nymk	åœ
nyff	æ’Ÿ
nyfk	å›¼
nydz	æ’ª
nyds	æº
nydv	æ“©
nylh	æ‹—
nylw	æ”‰
nyks	æŒ 
nyqq	æ’¬
nyzd	æŒ¨
nyzs	æ”¬
nysk	åœ—
nysj	æ’§
nysv	æ°
nyvt	æ‘¼
nyvj	æ‘´
nyyt	ç¾€
nyys	æ‘» æ’¡
lbbf	åƒ’
lbbk	å€¥
lbbr	å•
lbmb	è²¨
lbfs	è¦«
lbdb	å‚¾
lbdr	å€¾
lbnr	è´§
lblm	å„œ
lblw	å‚•
lbkb	å„
lbkm	ä½‡
lbkc	å‚¢
lbhd	ä¾¬
lbht	åƒ¿
lbhq	ä¾˜
lbjj	å€‡
lbjy	å‚€
lbqb	å‚§
lbzz	å„—
lbrf	å•»
lbrq	é¶™
lbrz	é†
lbvx	å€§
lbvs	ä¿’
lbyl	å€Š
lbyx	å‚Ÿ
lpby	å€¯
lppx	åƒ¸
lppz	å„Š
lpnq	éµ‚
lmbp	å¨
lmbd	å´
lmbv	å„© é„®
lmfn	å‡¾
lmfk	äºŸ
lmfq	ç„
lmtj	é¥
lmld	å€™
lmkb	å€¶
lmkp	ç–
lmkm	å
lmkd	å„‡
lmsb	é¡„
lmsn	å‡½
lmsk	ä¸
lmsj	åº å·¹
lmsq	çƒ è„€
lmss	æ‰¿
lmvq	å
lmwt	å¹
lmwl	æ‚ 
lmwg	é—
lmwh	ç– å€ ç„‚
lmwj	é‹š
lmwq	å€ è„© å„µ é¯ˆ
lmwx	çµ› ç¿›
lmwz	è·¾
lmws	ä¿®
lmyw	å„¸
lfpb	è³²
lfpt	å ¡
lfph	ç…²
lfmb	å‚Š
lfmj	ä¿‹
lffb	å„§
lffp	åƒº
lfff	å˜
lffj	å”
lffs	åƒ¤
lffr	åƒ£
lffw	å„¼ éº£
lfkd	ä¿£ éºŒ
lfkh	å®
lfhf	ä¾¶
lfhd	è¢
lfhw	è«
lfjd	ä¿
lfsb	åƒ“
lfsz	å„™
ldpm	éºŸ åƒ¯
ldpx	å»
ldmf	ä¿–
ldmg	ä¼“
ldmk	ä¼¾
ldmr	åƒ§
ldfj	å€¦
ldfq	å„¯
lddb	è´•
lddm	å‚„
lddn	å­µ
lddg	åµ
lddx	åƒš
ldds	æ¯ˆ
ldtc	å«
ldnd	å„
ldnq	é´‚
ldns	å­
ldnv	ä¾•
ldnw	å„ª
ldlg	ä¼ª
ldlq	å½
ldgh	ä¿¤
ldkm	å€š
ldkf	åƒ
ldkd	å‚
ldkn	ä½¯
ldkk	å‚
ldkh	å‚”
ldhm	é£› é£
ldjl	æ€¹
ldjg	å§
ldxc	åƒ”
ldxv	å¤
ldsn	å€´
ldrj	ä¿º
ldrz	å‚±
ldrs	ğ«¢¸
ldvj	ä¾‰
ldvx	å€·
ldwq	å„€
ltbw	å€°
ltdg	å€–
ltdq	å‚¤
lttt	å„¡
lttx	å„½
ltts	åƒ¥
ltnq	é¶¹
ltlh	ä¾½
ltkd	å
ltkq	å„
ltkr	ä½©
lthy	å‘
ltyx	å‚«
lnbf	å•†
lnbx	å­®
lnmb	å­­
lnmh	å‹
lnmx	å­¾
lnfd	å„¾
lntf	å€œ
lnln	å­– å­¨
lnlr	å­´
lngb	å€
lnkk	å­²
lnkx	åƒ¶
lnhl	æ„»
lnhk	éº•
lnhx	å­«
lnhz	éœ
lnxm	å­»
lnxz	é€Š
lnsb	ä¿± æ­’
lnsf	å•‡
lnsg	ä¿…
lnsk	å€‹ ä¼µ
lnsz	é©
lnss	å­¢
lnsw	æ•µ ç”‹
lnrd	ä¾§
lnwr	å­©
lnyf	å­¡
lnyv	å­º
llbf	å‚
llbr	å™
lllp	æ©¤
lllx	ç¹ 
lllw	æ…¶
llgm	ä¼ƒ
llgf	åƒª
llgn	ä¿‘
llgk	åƒœ
llkb	å„±
llkf	å€ ä¼º
llkd	ä¾¯
llkl	å„„
llkk	å‚¡
llkx	å€¿
llkz	å‚½ éº
llks	å‚¹ å„­
llkr	å£
llkv	åƒ® é„‡
llhf	ä¼½
llzq	å¦
llcs	å
llsm	å‰
llwn	å„
llwq	åƒ¬
llyh	ä¿²
llyw	å‚š
lgmv	å‡ éºš
lgdk	å‹
lgnn	ç”¬
lgnl	æ¿
lgnk	åœ…
lgnh	å‹‡ å‹ˆ
lgnz	é€š
lglb	é 
lglm	äºˆ
lglf	ä¾·
lgln	åƒ
lglx	è±«
lglc	ä¿¯
lglr	é¢„
lggb	å„£
lggx	å‚“
lggc	å
lggv	ä¾­
lggw	åƒ±
lgkt	å“
lgkh	éº›
lght	å‚‚
lghn	å‚™
lghl	æ†Š
lghq	ä¾‚
lgxb	ä¿½ å„¨
lgxm	å‚­
lgxf	å‚
lgcp	æŸ” æ¥˜
lgcm	éª› ç€
lgcf	çŸ
lgcd	åŠ€ å¥¦
lgct	å ¥
lgcn	é¹œ é¹¬
lgcl	çŸœ æ„—
lgcg	çŸ éª
lgch	å‹™ åµ ç†ƒ
lgcj	éª
lgcq	é¨– æ°„ çŸŸ é¶” é¶© é·¸
lgcx	å©º
lgcz	é¹
lgcr	æš“ çŸ 
lgcv	çŸ¡
lgcw	æ•„
lgcy	èŸŠ è¥
lgsm	å±
lgsf	å€¨
lgvd	ç™¸
lgvt	å‡³
lgvg	æˆ£ ç™¶ ç™·
lgvk	ç™»
lgvz	é‚†
lgvs	ç™¼ ç™¹ ç™º è¦´
lgvv	é„§ é„ˆ
lgyb	åƒ™
lkbm	ç«š
lkbc	ç«•
lkbs	ç«©
lkby	å„ ç«¤
lkpx	æ–°
lkps	è¦ª
lkmq	å‚¿
lkfm	ä½• å€³ ç«’
lkfd	å‰–
lkft	åª
lkfn	å­ 
lkfk	ä¾¸
lkfh	å‹
lkfj	å‚´ éƒ¶
lkfs	è¦—
lkfv	éƒ¨
lkfw	ç“¿ æ•¨
lkfy	ä½¿
lkdp	ä¿«
lkdd	ä¾ 
lkdc	ç«´
lkds	ä¼»
lkdr	ç«¡ ç«²
lktk	åƒµ éº 
lkty	é¢¯ é£’
lknt	ä¾¢
lknl	å„·
lkng	ä¿ª
lknj	ä¼…
lknq	é´—
lknr	ä¿©
lklk	ç« ç«³
lklr	æšœ
lkgk	ç«®
lkgj	ä½¢
lkgr	ä¾‡
lkkp	ç«¦
lkkx	ç«µ
lkkc	ç«±
lkhf	ç«™
lkhn	ç«” ç«¬
lkhl	æ†¨ è¼
lkhg	é¥
lkhh	ç«§
lkhz	ç«¨
lkhc	ä¿¨
lkhs	ç«
lkhv	ç«¯ å€»
lkhw	æ•¢
lkjb	è²¸
lkjp	æŸ‹
lkjm	ç««
lkjd	è¢‹
lkjt	åˆ
lkjn	ç‰®
lkjg	ä»£ æˆ¼
lkjk	ä»¾
lkjh	å²± å‹­
lkjq	é»› å»Œ æ°ƒ
lkjx	ğ¦’
lkjr	è´· å¸’
lkjv	ç«¥
lkqb	é¾ é¾– é¾˜
lkqf	ç¤±
lkqd	è¥² é¾‘
lkqt	å£Ÿ
lkqn	é¾
lkqg	é¾” ä¿Œ é¬´
lkqh	è¾
lkqq	é©¡ é¸—
lkqx	é¾’
lkqc	å‚…
lkqr	å‚®
lkqw	è®‹
lkqy	ç«‘ è ª
lkxg	ä¾™
lkxh	ç«—
lkxx	ç«¶ ç¿Š
lkxz	å€¢
lkzb	è´› è´‘
lkzl	æˆ† æˆ… æˆ‡
lkzz	åƒ† é§
lkzs	å½°
lkzr	èµ£
lkzv	é„£
lkzw	åƒŒ ç«·
lkcb	é¡¡
lkcl	åƒ«
lkck	ä¿¹
lkcx	æ–µ
lkcs	æ¯…
lkcv	ç«°
lksk	ä¿“
lksv	æ”±
lkrb	éŸ» æ­†
lkrp	å€ˆ å€²
lkrm	éŸ¸
lkrf	éŸ¶
lkrd	éŸµ éŸº
lkrl	æ„ åƒ¡
lkrg	å€† ç«›
lkrj	ç«­ åƒ ç«œ
lkrq	æˆ  é¶• é·¾
lkrx	å¬œ
lkrz	éŸ¼
lkrc	å‚³ éŸ·
lkrs	ç«Ÿ ç«¸
lkrr	ä¿  éŸ´
lkrv	é €
lkrw	éŸ¹
lkry	ä¾¿
lkvq	é–
lkyd	å€’ ç«¢
lkyt	ä¾„ è€‹
lkyj	ä¼›
lkyq	ç«“
lkyr	å‚¸
lkyw	ç«£
lhpf	ä¿°
lhpd	ä¿
lhpl	åƒ½
lhph	å¢
lhpx	å€­
lhpr	éº˜
lhpy	ä¿¬
lhmb	åµ
lhfb	è³€
lhfp	æ¶
lhfm	é©¾ å“¿
lhfd	è¢ˆ
lhfn	åŠ
lhfl	ä¹«
lhfq	é§• æ¯  é´
lhfx	å¦¿
lhfz	è¿¦
lhfc	å—§
lhfr	è´º
lhfy	è™±
lhdd	ä½»
lhdt	åƒ 
lhdl	ä¹® åƒ
lhdv	å³
lhtb	å„¹
lhtf	ä¿ˆ
lhtl	å„¢
lhts	ä¾
lhnt	å‚‹
lhnl	å‚¯
lhnq	ä¿„
lhnr	ä¾¦
lhnw	å‚»
lhlf	å„¶
lhll	å‹°
lhlh	åŠ¦
lhlq	è„…
lhlx	å§­
lhls	ä¼œ
lhlw	å‚¬
lhgg	å€‚
lhgv	å¸
lhkf	åƒ•
lhhp	å„
lhhh	åƒ—
lhjp	å„
lhjd	å¿
lhqc	éº
lhxz	å¼
lhzb	è³ƒ
lhzp	æ  
lhzt	å‡­
lhzl	æ
lhzg	ä¾¹
lhzq	éµ€
lhzr	èµ
lhsf	ä½¸
lhsk	å€•
lhsj	å›
lhrl	ä¾º
lhrw	åŸ å„Œ
lhyx	ä¿‚
lhyy	å‚°
ljmb	å©
ljmr	å„ˆ
ljmv	å‚
ljft	å„³
ljfr	å„‰ å€¹
ljnc	å€«
ljgp	å‚‘
ljgf	ä½²
ljgg	ä¾ˆ
ljgr	ä¼¼
ljkx	æ–²
ljqd	å·
ljqg	åƒ¦
ljxm	é¿‡
ljxl	æ‚¨
ljcj	ä½¹
ljcw	å„‹
ljsk	ä¿­
ljsr	å‚¨
ljvx	å‚º
lqmn	ä¾Ÿ
lqmk	ä¸±
lqmh	ä¼¢
lqkk	åƒ¼
lqjg	ä¼˜
lqxk	ä½
lqcd	å„‚
lqsr	åƒ­
lqvr	åƒ€
lxbv	ä¾µ
lxmb	åƒ¹
lxdp	åƒ³
lxds	åƒŠ
lxng	å¥
lxlf	ä¿‰
lxlk	ä¼
lxhm	å—
lxhf	ä¾° éº é¿˜ é¿š
lxhx	é¿™
lxjm	åƒ²
lxjd	å€€
lxjg	ä½
lxxs	åƒ‡
lxsm	å„˜
lxvx	åƒ„
lzbm	åƒ¢
lzbw	åƒ¾
lzmb	å„¥
lzmv	ä½œ
lzff	åƒ–
lzft	å„“
lzfy	è›‹
lzdf	å€
lznt	å
lzln	ä¿˜
lzlh	ä¼¤
lzlc	å„”
lzhq	åƒ
lzjg	ä¾®
lzzh	å‚œ
lzsm	å„›
lzrk	ç–
lzrv	å‚· é¬º
lzyd	å‚’
lcmg	å„š
lcfq	éº™
lcnd	å€
lclj	ä¼Œ
lckp	å
lckf	å‚¼
lckh	å‚‡
lckj	ä¼³
lckv	åƒ…
lckw	å„º
lchm	å„®
lchd	å‰·
lchx	å‚†
lchv	ç”£
lcjw	å„†
lcqf	åŒ
lcxh	äº·
lczq	å„°
lccp	åƒ·
lcsb	é¡” éº’ å€› åƒ›
lcsn	åƒƒ
lcsj	å¡
lcsq	å‚¶
lcsz	éƒ
lcsr	é¢œ
lcvd	ä¾² éº
lcvc	å‚‰
lsbn	ä¾¼
lsmd	å°
lsmj	å€¤
lsfb	å„Ÿ éŸ¥
lsfp	éŸ– éŸ˜
lsfm	éŸ‹ éŸ éŸ
lsff	éŸ
lsfd	éŸ”
lsft	å„… éŸ
lsfn	éŸ• éŸ›
lsfl	éŸ¢
lsfg	éŸ éŸš
lsfj	éŸœ
lsfq	å„» éŸ’ éŸ¤
lsfz	é• éŸ—
lsfs	å‚¥ éŸŸ éŸ  éŸ¡
lsfr	éŸŒ
lsfv	éƒ¼
lsfw	åš
lsfy	è¨ éŸ£
lsnf	å€˜
lsnq	é³µ
lsns	å€¼
lsnw	åƒ˜
lsny	å„ 
lsks	ä¾Š
lshc	ä¿¦
lshw	ä¿‡
lsqn	ä¾¾
lsqj	ä¾¤
lsqr	å–
lsxv	ä¿¶
lscb	åƒ¨
lscr	å¾
lssm	èˆ
lssg	åƒ
lsrn	ä¿¸
lsrs	å‚£
lsrr	å†
lsvl	å¬
lsvy	å¿
lrbb	å€±
lrmv	åƒˆ
lrfx	åƒ‚
lrlb	åƒ‹
lrlg	ä¼¶
lrlj	ä¼§
lrgf	å€½
lrgs	å„¤
lrkv	å’
lrxf	å‚–
lrxx	å‚
lrsj	åˆ
lrrt	ä¾³
lrvy	ä¾©
lryq	å„‘
lvbp	å½š
lvmb	å‚µ
lvmm	ç›
lvmd	å‰¥
lvmg	å€µ
lvmz	é€¯
lvms	å½•
lvdn	å½ å½›
lvnr	å€º
lvlw	å‚©
lvhd	ä¿µ
lvjg	ä¼  å¤›
lvqs	å„¬
lvvr	åƒ´
lvvy	åƒ©
lvyx	å‚ƒ
lwbm	åœ
lwbq	ç‡
lwbc	å„«
lwmf	å€ƒ éº”
lwmn	é›‹
lwmr	åº
lwfd	å„´
lwdb	é¡€
lwdv	å„• éº¡
lwnf	å‚
lwlp	é›§
lwln	çŠ¨
lwlv	é›™
lwlw	è® é›” é›¥ é›¦
lwhd	ä¾ å¯
lwhk	å„ƒ
lwjx	ä¾«
lwjw	é› 
lwqb	é¡¦
lwqm	ä½­
lwqd	åŠ
lwqn	é¹ª
lwqq	é·¦
lwsq	é¶½
lwsr	å„²
lwrs	å€…
lwwn	çŠ«
lwww	è®
lwyf	éº
lwyt	å‚—
lwyh	éº
lwyq	ä¾ª ä¿¼
lwyr	ä¾…
lybw	ä¿Š
lymj	ä¿·
lyff	åƒ‘ éº¢
lydb	é 
lydv	å„’
lynq	éµ
lynw	é¬·
lylh	åŠ¹
lygt	å¡
lygg	ä¿´
lykj	ä¿œ
lyks	ä¾¥
lyhd	è¡®
lyht	è™ 
lyhn	ä¾”
lyqq	å€„
lyqr	ä¿™
lyqw	å„
lyzm	å„–
lyzd	ä¿Ÿ
lysh	åƒ
lysv	å…
lyyq	åƒŸ
lyys	å‚ª
gbbk	è°¾ éš
gbfy	è· è¸ è ¯
gbdb	å»
gbdx	å±ª
gbdr	åº¼
gbhv	å»€
gbjy	å»†
gbyp	åºº
gppb	é»‚
gppp	ç³œ ç©ˆ
gppm	éº½
gppf	ç£¨ é¡ éº¿
gppd	åŠ˜
gppt	å¡º
gppn	æ‘© çŠ˜
gppq	éº¾ çˆ¢
gppx	ç¸»
gppr	é»
gppv	é»€
gppy	éº¼ é­”
gmbb	å±­
gmbd	å»
gmbx	å»®
gmmv	å½
gmgt	å•
gmgj	çˆ¬
gmgs	çˆ®
gmkd	å½‹
gmsd	åŠš
gmsn	çŠ€
gmsx	æ–¸
gmsz	é²
gmsr	éœ
gmsy	å±¬
gmvz	é
gmvv	åš
gffn	çŠŸ
gffh	å‹¥
gffs	å½ˆ
gffw	è¬½
gffy	å¼º
gfqs	æ—¤
gfsb	é¼
gdpl	é¬»
gdpg	ç²¥
gdpx	å±¡
gdmb	é ‡
gdmz	å±£
gdmr	å±¤
gdmw	å»ˆ
gddx	å±¦
gdnr	é¡¸
gdgd	å¼±
gdgq	é¶¸
gdkd	åŠ†
gdkn	åº  ç¾¼
gdkh	å»‰
gdkz	é…
gdkc	å½…
gdxv	é§
gdzw	å±¥
gdcp	å±§
gdcj	å±œ
gdsv	å±
gdrg	å¼¼
gdrj	åºµ
gdrx	å±¨
gdrs	å¼¹
gdyf	å±©
gtbw	åº±
gtdz	éŸƒ
gtkk	ç–†
gtym	å»…
gnpn	é¹‡
gnmd	é˜›
gnmq	é˜’
gnmv	å¼¢
gnff	é—¾
gnfr	é˜“
gnfv	é˜
gnfy	é—½
gndk	é‡
gndj	é˜‰
gndx	é˜…
gndz	é—¼
gnds	é˜
gntm	é˜–
gntt	é—º
gnnb	é˜™
gnnk	é˜ƒ
gnld	é˜•
gnlg	é˜€
gnlk	é¡
gnlw	é˜š
gngg	é˜†
gnkp	é˜‘
gnkf	é˜”
gnkh	é—»
gnkq	é˜ˆ
gnhp	ğ«”¶
gnhj	é—¿
gnjj	é˜ é˜„
gnjs	é˜‹
gnqy	é—³
gnxt	ğ¬®±
gnxr	é˜
gnzv	é˜Œ
gnsr	é˜‡
gnsv	åºª
gnrx	é˜˜
gnrr	é˜Š
gnvd	é—±
gnwf	é˜
gnwt	é—¶
gnwr	é—¹ é˜‚
gnwy	é—µ
glds	è¦›
glnn	å­±
gllf	å™Ÿ
glln	é¹°
glll	æ‡‰
gllq	é·¹ è†º
gllw	è­
glgp	é£
glgm	åº
glgs	å»¢ å»ƒ
glkb	é¾ è±…
glkf	é›
glkq	éŸ€
glkv	å»
glkw	è±ƒ
glky	é­
glch	ç„¤
glcr	è…
glsr	æ˜¶
ggfj	æ‰ˆ
ggfw	å•Ÿ
ggnf	æ‰ƒ
ggnq	é¨— é³¸ é¶£
ggnx	ç¿©
ggnz	é
ggnc	æ‰
ggnw	ç”‚
gglb	é¡§
gglw	é›‡
gggb	å½
gggl	ä¹º
gggx	æ‰€
gghf	æ‰‚
gghn	é´
gghh	æ‰Š
ggjd	å±•
ggjg	æ‰…
ggjv	å»Š
ggqb	é¡…
ggqq	éµ³
ggxn	è‚
ggxx	æ‰‡
ggst	å£‚
ggsh	ç„ˆ
ggsq	è‡€
ggsr	å»œ è‡‹
ggrk	æ˜¼
ggvs	æˆ½
ggwp	æ£¨
ggwf	å•“
ggwd	æ‰†
ggwn	è‚‡
ggwx	ç¶®
ggwr	æ™µ
ggyb	å»£ å½‰
ggyf	å•”
ggyn	è‚ˆ
ggyl	æ‡¬
ggyv	é„º
gkbg	ç“•
gkby	å½Œ
gkmj	å·µ
gkfm	å½
gkft	å•
gkfh	åŠ¶
gkfj	å½„
gkfz	é€…
gkfv	éƒˆ
gktk	éŸ å½Š
gknl	å»²
gkng	å¼»
gknj	åº‰
gklj	å®
gkgj	å¼¡
gkhl	å»³ å»°
gkqg	åº¯
gkzb	å»¤
gkcy	ç“¥
gksk	å¼³
gksr	é¿®
gkrp	åº²
gkry	é•
gkyd	å‰­
gkyt	å±‹ åº¢
gkyj	ğ«¸©
ghpb	å»­
ghph	é¦
ghms	è¦
ghfn	å±
ghdd	åº£ é‰
ghtb	æ­‹
ghtm	å»¬
ghtn	ä´˜
ghtq	é·‰
ghtz	é
ghnt	é²
ghgg	å±›
ghzg	åº­
ghrs	å»
gjmr	å»¥
gjmv	å»‹
gjfn	é¥
gjfj	éƒ’
gjlh	å‹†
gjhg	åºŸ
gjqn	å»¯
gjqs	å»
gjcn	å»¨
gjcw	éŸ‚
gjvt	å»›
gjvv	é„½
gjvy	é¿¥
gjyp	ã®¾
gjyt	å¡±
gqbb	é«Œ é«•
gqbf	é«‚
gqbg	åº é«–
gqbj	é«‹
gqbw	é«‰
gqmb	è²» éª´
gqmh	åºŒ è°º
gqmv	é„ª
gqmy	é«‘
gqdb	é¡
gqdk	éª¿ é«Š
gqdj	éª»
gqdx	é«…
gqts	é«
gqnq	é¶»
gqnr	è´¹
gqlf	é«ˆ
gqly	éª¹
gqgp	é«
gqgf	éªº
gqkn	éª¬
gqkg	éª®
gqkc	é«†
gqky	éª¾
gqhm	é«—
gqhl	éª©
gqjg	åº¬
gqjj	è‰´
gqqk	é«”
gqqz	é«“ é«„
gqxg	éª¶
gqxs	é«
gqzx	éª½
gqcn	é«’
gqsf	éª·
gqss	éª²
gqrp	é«
gqrn	é«ƒ
gqrq	éª±
gqrx	é«
gqvr	å»—
gqwf	éª¼ é«‡
gqwt	éª¯
gqwr	éª¸
gxmm	å½‡
gxmf	å”
gxmj	å¼¬
gxmq	é¶¶
gxms	åº·
gxmv	é„Œ
gxmy	æ–¶
gxdb	é 
gxdz	éŸ†
gxdr	é¢€
gxng	é¬
gxll	æ…‡
gxlh	åŠ¤
gxls	æ®·
gxgb	è³ª
gxgf	å• 
gxgd	åŠ•
gxgx	æ–¦
gxjd	å¼µ
gxjg	åº• å¼¤
gxqm	åº¸
gxqq	é·›
gxqv	é„˜
gxxs	å»– è±‚
gxrb	è³¡
gxrn	é¹’
gxrq	é¶Š
gxrr	èµ“
gzmb	è±„ éŸ‡
gzfc	å»š
gzsq	å»¡
gzyd	è±€ éµ
gcmq	éŸˆ
gcnq	é¶Œ
gclq	éŸ‰
gclv	éŸ„
gckp	å±Ÿ å¼½ é¢
gckd	å‰«
gckn	é¹§
gckg	åº¹
gckj	å±‰ é¾
gckq	åº¶ é·“
gckz	é®
gcks	é¾
gckr	å¸­ åº»
gckv	åº¦ å»‘
gcky	ä—ª
gcjf	é³
gcqn	é¯
gcsx	å»
gcvp	éŸŠ
gcvd	å±’
gsmb	è²­
gsmg	ç‚
gsmq	é¶
gsmx	ç·³
gsmz	é
gsfd	å‰§
gsft	éº
gsfq	é¶‹
gsfw	å»±
gsdp	é 
gsdf	å±«
gsnf	é
gsnr	è´¨
gsnw	å» 
gsqd	é©
gsqn	åº¨
gsqq	é·µ
gsqr	å± 
gszy	å»Ÿ
gsrh	å»§
gsrs	å¼¾
grfx	å±¢ å»” é»
grnq	éµ²
grlf	è°½
grgx	æ–®
grgs	å½ƒ é¸
grsj	é¨
grrt	åº§
gryq	éŸ…
gvkm	å±™
gvxd	è¤½
gvxn	çŠš
gvxl	æ…°
gvxk	å¼ª
gvxh	ç†¨
gvxc	å°‰
gvxv	å
gvxy	è±
gvrz	é€“
gvry	å»•
gwln	å¼´ éŸ
gwlv	å»“ é¹
gwhp	å»©
gwhd	åº¡
gwhx	å»ª
gwyx	å©±
gybf	é»‡
gybt	é»ˆ é»Š
gybl	é»…
gybq	é·¬
gybs	æ–¢ é»†
gyff	é½
gyfy	å¼·
gylh	é¿
gyqn	å±˜
gyqc	å±—
gyxs	å»«
gyyq	é¿
kbbp	æ·±
kbbf	æ»˜
kbbt	æ¼¥ æ½Œ
kbbg	æµ« æº›
kbbk	æ¶³
kbbh	æ»µ
kbbq	æ¹¥
kbbr	æ¹
kbmb	æ¿µ
kbds	æµ‘
kblm	æ¿˜
kbln	æ¾
kbkb	æ¼” æ¿±
kbkm	æ³
kbkk	æ¸²
kbkz	æ¸¾
kbkc	æº•
kbhd	æµ“
kbht	ç€‹
kbhn	æµ¶
kbhz	ç€½
kbjj	æ¶´
kbjq	ç€‰
kbjy	æº¾
kbqb	æ»¨
kbqy	æµ¤
kbxv	æ¿…
kbcm	æ¹“
kbsl	ç€—
kbsv	æ¼ƒ
kbrt	å£
kbrl	æºŸ
kbrg	ç’½
kbrq	é¸
kbrz	é‚‡
kbrs	è¦¼
kbry	çˆ¾ è ’
kbvp	æ»±
kbvx	æ·™
kbvs	æµ£
kbyk	æ»
kbyx	æ»ƒ
kpby	æ·
kppp	æ½¹
kppf	æ»¼
kppt	æ¼œ
kppq	æ½¸
kppx	æ¼¤ æ¾¿
kppz	æ¿‹
kppr	æ¾˜
kpdf	ç¢†
kptt	æº
kpgx	æ·…
kphr	æ¹
kpzs	çª
kprk	æ¸£
kprs	æ¼†
kpvx	æ¸¿
kmbd	æ¸¬
kmbg	æ¿º
kmbx	ç€´
kmbv	ç€ƒ
kmpq	é¶«
kmmb	ç€•
kmmm	æ¾
kmmh	æ¶‰
kmmj	åŒ·
kmmr	æ¿’
kmmw	çˆ
kmdb	é ‚ é ™
kmdr	é¡¶
kmtt	æ¿¹
kmtg	æ¾¤
kmtq	æ½¶
kmnq	é´Š
kmlr	æ½€
kmlw	æ¿‰
kmkd	æ¾´
kmkq	ç„‰
kmkv	é„¢
kmjl	æ¿
kmxh	æ¸º æ¸‰
kmcd	ç€±
kmcq	æ¿Š
kmsm	ç©
kmsk	çƒ
kmsj	ç§
kmss	æ¸
kmsr	æ¶¾ æ¿–
kmsy	æ¿
kmvq	é•
kfpb	è³´ æ¬¶ é ¼
kfpm	æ•´
kfpd	å‰Œ
kfpn	æ§
kfpl	æ…—
kfph	å‹…
kfpq	éµ£ é¶’ é·˜
kfpx	è¾¢
kfpz	é€Ÿ é« é¬
kfpr	èµ–
kfpw	æ••
kfmb	æ­Œ æº³
kfmm	å“¥
kfmf	æ½
kfmg	æˆ¨
kfmj	æµ¥
kfmv	å“ æ †
kffb	æ­ æ¿½
kffp	æ¾¡ æ•º
kffd	å‰¾
kffl	æ¼¶
kffh	æ¾
kffj	å€ åŒ° æ¹‚
kffq	é·—
kffs	æ¯† æ½¬
kffr	æ½œ
kffw	ç”Œ
kfdb	é ­ è±
kfdd	å‰…
kfdk	è±† è±‡
kfdh	è± é¿²
kfdj	è±Œ
kfdq	æ¯­
kfdz	é€—
kfdv	è±‰ éƒ–
kftd	å‰¯
kftt	ç–ˆ
kftq	é¶
kftz	é€¼
kfnr	æ¶¢
kfkd	æ´–
kfkl	æƒ‘
kfkg	å½§
kfkh	æ¹’
kfkq	æˆ– æ¿ˆ
kfjc	å°€
kfxm	äº‹
kfxd	å‰š
kfzn	æ¸¸
kfzj	æ¹¤
kfzz	æ¼©
kfsb	æ½°
kfsj	åŒ® åŒ±
kfsz	ç€¢
kfsr	æºƒ
kfrj	æ¸‘
kfrv	æ·¤
kfvl	æ‚ª
kfvk	äºœ
kfwt	å¡£
kfwq	æˆœ
kfyk	æ¸± ç—
kdbb	æ¾¬
kdpm	æ½¾
kdpl	æ…­
kdpg	ç€µ
kdpx	æº‡
kdpr	èµ‰
kdmb	æ¹
kdmz	æ¼‡
kdms	å¿ æ²—
kdmr	æ½§
kdfj	åŒ² æ·ƒ
kdfx	æ½«
kdfs	æ¼›
kdfy	èš•
kddb	é ¬
kddm	æ¸
kddd	åˆ¾
kddx	æ½¦
kddr	é¢Š
kddv	éƒ
kdnd	æ¸œ
kdnq	é´Œ
kdns	æ¹
kdnv	æ´
kdnw	ç€€
kdlg	æ²©
kdlq	æºˆ
kdgm	æ´²
kdgh	æ¶•
kdkm	æº¢ æ¸
kdkd	æ¹” æµ‚ æ¸† æ¸•
kdkn	æ´‹
kdkl	æ¿¨
kdkg	ç€
kdkk	æ¹´ æº 
kdkh	æº“
kdkz	æ¾»
kdkr	æµ‰ æ½½
kdky	æ»‹ è… è º
kdhw	ç€“
kdjj	åŒœ
kdxm	äºŠ
kdxc	æ¾Š
kdxv	æ¹­
kdzw	æ¾“
kdcd	æ¶¿
kdsn	æ¸€
kdsj	åŒ¦
kdsx	æ¸
kdsz	æ¶Ÿ
kdsy	æº¬
kdrj	æ·¹
kdrz	æ¼
kdrr	å¥­
kdry	å¥£
kdvm	æ´
kdvj	æ´¿
kdwd	æ¸¼
kdwj	æ¹µ
kdwq	æº” æ½ƒ
kdws	æ¼¾
ktbt	æ·•
ktbw	æ·© æº­
ktpq	æº¨
ktfd	æº’
ktfq	æ¸½ ç€
ktdn	æº¿
ktdg	æ¶¬
ktdz	æ¾¾
kttt	ç…
kttq	ç€»
kttc	æ¹—
ktts	æ¾†
ktkd	æ¸¨
ktkk	ç•º
kthy	æ¸¢
ktym	æº˜
ktyx	æ¼¯
knbf	æµ»
knpp	æ£˜ æ£—
knpd	åˆº
knpk	æ¶ƒ
knpr	åƒ°
knpv	æ£
knpw	æ•‡
knfd	ç¢
kndk	æ´‡
kntf	æ·
knlk	æ½¿
kngb	æ·Ÿ
kngn	é¹‚
kngl	éº—
kngg	ä¸½
kngq	é¸
kngx	æµ™ å©¯
kngz	é‚ é€¦
kngs	å½¨ å½²
kngv	éƒ¦ é…ˆ
knkk	æº· æ¼
knkx	æ¾ 
knjb	é “
knjf	æ¹
knjz	è¿
knjr	é¡¿ æ—¾
knjv	é‚¨
knsm	æ¹ƒ
knsg	æµ—
knsk	æ¶¸ æ³—
knsj	åŒ©
knsy	æ»
knrm	æº«
knrd	æµ‹
knrk	æ³…
knrq	æº…
knrr	ä¸¤
knvm	æº‹
knvk	æ¶ 
knwk	ğ¬‡¹
knws	æµµ
klbf	æ»‚
klbr	æ¸§
klmt	æ»Œ
klmn	æ¶µ
klml	æ»º
klmk	æ´†
klmq	æ»«
klmw	æµŸ
klfp	æ¹º
klfd	æ»¾
klfy	ç€œ
klnf	æ»´ æ»³
kllk	æ¶–
klgb	æ¾¦
klgp	æ¸˜
klgm	æ±¿
klgf	æ½
klgd	æ¹€
klgn	æ¶Œ
klgl	æ…‚
klgk	æ¾„
klgh	æ¹§
klgs	æ½‘ æºŒ
klgr	æ»ª
klkb	ç€§ ç¨
klkf	æ¶ª æ³€
klkl	æ¾º
klkj	æ»
klkq	æ¹‡
klkx	æ· æ¾µ
klkz	æ¼³
klks	æ»° ç€™
klkr	æ¹†
klkv	æ½¼
klkw	æ¾‰
klky	ç‹
klhf	æ¿® æ³‡
klhd	æ³–
kljd	ç€
kljg	å¿’
kljc	æº£
klxh	æ´¢
klzq	æ¹‘
klch	æ¿“
klcv	æ»»
klsm	æ¹‹
klvg	ğ¬¡
klvh	çƒ«
klvs	æ¸Œ
klwp	æ½—
klwj	é¾¨
klwq	æ½
klws	æº–
klyd	æ»š
klyg	æµŒ
klyw	æ»§
kgbt	åŸ¿
kgpf	ç–
kgmn	æ¼½
kgmg	æ² 
kgmv	æºŠ
kgmy	çŸ
kgfz	æ¿„
kgfy	æ¼’
kgdd	æºº
kgdh	æ¿‚
kgnp	æ¾œ
kgnr	æ¶§
kgnw	æ¶¦
kgld	æ´¾
kgln	æ½º
kgls	æ³³
kggb	ç€‡
kggp	æ·­
kggd	æ¶™
kggj	åŒ¾ æ»¬
kggq	æ·š
kggs	æ¾±
kggv	æµ•
kgkf	æ´‰
kgkt	æ¸¥
kgkh	æ¸³
kgky	ç€°
kghl	æ³¦
kgjt	ç€
kgjl	ä¹¬ å·ª
kgjy	è¶
kgqw	æ½µ
kgxm	æ»½
kgxf	æº
kgxd	æ¼²
kgxt	å½
kgxh	å³¾
kgxj	åŒ 
kgxs	æºµ æ¼®
kgcv	æ¸¡
kgsf	æ¶º
kgsr	æ½³
kgrd	æ¶®
kgrq	é´º
kgyb	æ½¢
kgyq	æµ˜
kkby	æ¿”
kkmp	æ¹…
kkmq	æ¼¹
kkfb	æ¼± ç€¨ ç€¬
kkfp	æ¶‘
kkfm	æ²³ æ»’
kkfd	æº‚
kkft	æ¹¢
kkfk	æµ¢
kkfj	æ¼š
kkfq	æ·¢
kkfr	æ¿‘
kkfw	æ½„
kkdp	æ¶
kkdd	æµƒ
kkds	æ·» æ³™
kknp	æ´“
kknm	ç›“
kknt	æ´…
kknl	ç‘
kknj	æ²Œ
kklj	åŒ¯ æ»™
kkgp	æ¸ 
kkgj	æ´°
kkgr	æ´Ÿ
kkhh	ç„
kkhr	æº
kkhv	æ» 
kkjg	å¼Œ
kkjk	æ²
kkjq	æ³§ æµ³
kkqg	æµ¦
kkqc	æº¥
kkqr	æ¼•
kkxx	æ·’
kkzd	ç€­
kkzt	å£
kkzh	è»
kkzj	åŒ­
kkzx	æ¼¸ å¬±
kkzz	æ¼£
kkzy	é­™
kkcr	ç€¦
kkst	æ¹½
kksk	æ¶‡
kksr	æ»
kkrp	æ¶· æ·¶
kkrl	æ½“
kkrk	æ´¹
kkrh	ç€’
kkrj	åŒ§
kkrc	æ¼™
kkrr	æµ¹
kkry	æµ­
kkwj	æ´­
kkyt	æº¼ æ´·
kkyj	æ²¤
kkyr	æ¼º
khbm	æ¿¬ è è¹
khbl	è¡
khbk	èœ
khbx	æ¼´ è¬ èº
khbz	è¢
khbc	è
khbs	è€½
khby	è­
khpb	ç€©
khpd	æµ°
khph	æ¹«
khpq	æ½²
khpx	æ¶¹
khps	æ½»
khmb	æ¹
khmn	æ¿
khmq	æº´
khmc	æ½¨
khfb	èµ
khfd	æ¾
khfn	æ¸ª
khfl	æƒ‰
khfr	è©
khfw	è–
khdm	æ¸Š
khdd	è” æ´®
khdt	æ½˜
khdn	æ³˜
khdl	èª
khdk	æ½‚ è 
khdv	æ¹ è
khtb	ç’
khtm	ç€˜
khtf	æµ©
khtl	æ¿¾
khtj	éŒ
khts	æ´— æ»®
khtr	æ¿³
khtw	æº¦
khnd	æ¾³
khnt	æº èƒ
khnl	æ¼—
khnk	æ»·
khnj	æ¾š
khnq	æ¶ éµˆ
khnr	æµˆ
khnv	è€¼
khlp	æŸ“
khld	èŠ è§
khlq	è·
khlw	æ¼¼
khgg	æ³›
khkb	é¡³
khkm	è€µ è‡
khkt	å©
khkl	æ¶
khkg	æˆ¬
khkk	æº°
khkh	è¶ è‘
khkq	è
khkc	æ¾½ æ¿§
khkr	æ™‹ è—
khkv	ç‡ é„‘
khkw	æ¾²
khhp	æ¿š
khhf	è’ ç€¯ è•
khhd	è è¤§
khhn	æ»¹ è¥
khhl	è°
khhg	ç€…
khhh	æ¾‡ æ¿™
khhj	ç
khhx	ç€ 
khhs	æ¿´
khjp	æ¾¯
khjk	ç€£
khjh	æ³²
khjs	è£
khjw	è¸
khqh	æ¹ 
khqy	è€¾
khzf	è
khzd	è…
khzg	æ¶
khct	æ¼„
khsf	æ´»
khsl	æ²œ è¦ è´
khsk	æ¶¶
khsr	æº—
khrb	æ½‰
khrp	æ¿¼
khrf	æ¾”
khrl	æ¶” è€¹
khrg	è†
khrs	æ¼‘ æ¹¶ æ»œ è„
khrr	æ·¿
khrw	æ¿€ æ¹Ÿ
khvp	æ£¸
khvf	é¿¢ é¿¤
khvt	åŸ¾
khvq	ç„£ è™
khvx	å¨¶ é¿£
khvc	èš
khvr	é¢ æº®
khvv	è‚ é„¹ éƒ°
khvy	è€º
khwm	è¤
khwn	æº„
khwl	è½
khww	æ¾‚
khym	ç€Š
khyd	è«
khyn	è¨
khyg	è€
khyk	è¯
khyh	èˆ
khyj	è˜ æ¹š
khyq	æ¯¦ è®
khyy	æ¼°
kjpp	æ½Š
kjpt	å¡—
kjpv	æº†
kjpw	æ¼µ
kjmd	æ¸™
kjmr	æ¾®
kjmv	æº²
kjft	ç€º
kjfn	æ¸°
kjfj	åŒ³ åŒ¼
kjfx	æ½
kjfz	è¶¸
kjfc	ç€¹
kjfr	æ¾°
kjfv	ã½
kjfw	ç€²
kjfy	è™¿
kjnd	æ¶£
kjnc	æ·ª
kjlk	äº’
kjlh	åŠ¢
kjlc	æ¹ª
kjls	æ·¥
kjgb	æ¿¥ è²£
kjgp	æ»
kjgf	æ´º
kjgn	é¸¢
kjgq	é³¶
kjgr	æ³¤
kjgw	éš¿
kjkq	æ¾™
kjkr	æ¾›
kjhg	æ³¼
kjqd	æ¸
kjqj	åŒ¬
kjqs	æº‰
kjqr	ç€‚
kjxm	æµ„
kjxl	ã´”
kjxk	æ¹¼
kjzs	æµ’
kjcn	æ¾¥
kjcj	æ´ˆ
kjcw	æ¾¹
kjsq	æ½Ÿ
kjsw	æ½‹
kjvx	æ¼ˆ
kjys	çš
kqbg	æ³·
kqmb	å–¸
kqmm	æ·µ ç›™
kqmf	æ—‰
kqmn	æ´Š ğ¬·•
kqml	ä¹¶ æ‡¯
kqmg	ç”«
kqmq	éµ
kqmz	é€‹
kqmc	å°ƒ
kqms	é¿¿
kqmv	éƒ™ é¼
kqmw	æ•·
kqdp	æ»Š
kqkm	ç
kqkk	æ¾§
kqkj	ç”
kqjg	æ²‹ æµ
kqcd	æ¿ƒ
kqsl	çŠ
kqsr	æ½›
kqrz	é­
kqvl	æ‡˜
kqvg	æ²·
kqvr	æ»¯
kxbv	æµ¸
kxmm	æ½š
kxmt	æ¾‘
kxmq	é¶ˆ
kxmx	å¦»
kxmv	éƒª
kxfj	æ´
kxdp	æ½¥
kxtk	æ¾…
kxnt	å »
kxng	æ¹•
kxlf	æµ¯
kxkb	æ¾’
kxkn	é¸¿
kxkg	å¼
kxkj	åŒ
kxkq	é´»
kxhp	æ¡¬
kxhm	æ¸»
kxhf	æ¶’ ç¡°
kxhd	è£Ÿ
kxhn	æŒ²
kxhl	ä¹·
kxhk	é²¨
kxhq	é¯Š
kxhx	å¨‘
kxhz	é€¤
kxjd	æ¶±
kxjl	æ²”
kxjg	æ³œ
kxjr	æ¶½
kxxf	ç€¥
kxxg	ç€·
kxxz	ç€ˆ
kxxc	æ½¯
kxxs	æ¼» æ¿¢
kxxr	æ¼
kxxw	æ¿¯
kxsm	æ¿œ
kxvx	æ¼‚
kzbf	è½„
kzbk	æ½±
kzbs	æ¶œ æ¿² ç€” ç€« è¼
kzbv	æ¶­ è¼¨
kzmb	ç€†
kzmd	è½˜
kzmj	åŒ´ åŒµ
kzmc	ç‚
kzms	æ¼
kzmv	æ³
kzfh	è¼¯
kzfc	æ¾
kzfs	æ¾ æ¯„
kzdb	è´€
kzdm	è½” ç– è¼¢
kzdd	è¼­
kzdn	é¹¥
kzdl	æ‚˜
kzdg	ç‘¿ è»š
kzdk	æ¯‰ è»¿
kzdj	åŒ» æ²²
kzdq	è½™ é·– é»³
kzdx	ç¿³ å«› ç¹„ è½‘
kzds	æ®¹
kzdr	æ½ª
kzdv	é†« è¼€ è¼¶
kztd	è½…
kztt	è½ 
kztw	è¼˜
kznp	æª•
kznm	è½€
kznf	ç¤Š è¼–
kznd	è»®
kznt	å¢¼
kznn	æ“Š
kznh	ç½Š
kznj	è¼
kznq	é¿‚
kznx	ç¹«
kznz	è½š
kzny	èŸ¿
kzlp	è¼®
kzln	æµ®
kzlg	æ¶
kzlc	æ¿¤ è»µ
kzls	è»
kzlw	æ½…
kzly	è¼ƒ
kzgp	æ§§
kzgm	è¼´
kzgf	ç£›
kzgd	è¼¾
kzgt	å¡¹
kzgn	è½
kzgl	æ…™ è»¶
kzgj	é¨
kzgx	æ–¬
kzgz	è¹”
kzgs	è¦±
kzgr	æš«
kzgv	æ¹²
kzkm	è»»
kzkt	è¼» è¼Š è¼º
kzkg	è¼” è¼› è»¾
kzkk	è¼•
kzkh	è¼Œ
kzkj	è¼’ è»˜ è»­ é‘‹
kzkz	è½Ÿ è½‹
kzkc	è½‰
kzks	è» è»¯
kzkv	è¼™
kzhp	è½¢
kzhm	è½¤
kzhf	è»¼ è½
kzht	è½“
kzhn	è»¤
kzhl	è»Œ
kzhg	è¼§
kzhq	æ½™
kzhz	æ·« è» 
kzhc	è½›
kzhv	è¼²
kzhy	è¼ˆ
kzjd	è¼¸ ç€„
kzjt	å¡°
kzjg	æµ·
kzjj	è¼¡
kzjx	ç€¿
kzjc	è¼ª
kzjs	è¼—
kzqg	è»·
kzxm	æ·¨
kzxf	è¼‘
kzxn	æ½·
kzxl	æ¿¦
kzxg	è»§
kzxk	æ¾¨
kzxj	è»
kzxs	è½‡
kzxv	è¼
kzzh	æ»›
kzzj	è½
kzzw	è¼¹
kzcm	è½£
kzcf	è»º
kzcl	è½—
kzcj	è»› è½•
kzcq	è¼±
kzcw	è½¥
kzsb	è½’
kzsp	è½ƒ è½ˆ
kzsf	è»²
kzsd	è¼³
kzst	è¼œ
kzsn	æ’ƒ
kzsh	è½–
kzsq	æ½• è¼
kzsx	ç¹‹ è½Š
kzss	è»³ è¼„
kzsw	è¼·
kzrb	è¼¥
kzrp	è¼ 
kzrm	è¼¼
kzrd	æ·›
kzrl	è»¡
kzrg	è»¨ é¾«
kzrj	è¼µ
kzrs	è»«
kzrv	æ¼¡ è¼°
kzvt	è»½
kzvq	è¼¤
kzvv	è¼Ÿ
kzvy	è»¢
kzwf	è¼…
kzwt	è»´
kzwr	è¼†
kzww	è½
kzym	è½
kzyf	è½ è»©
kzyd	æºª
kzyt	è¼½
kzyg	è¼š
kzyh	è»ª
kzyq	æ»— è» é¸‚
kzyx	è½Œ
kzyv	è½œ
kzyy	è¼£
kcbp	æº
kcbg	æ»¢
kcbh	æ¶
kcbx	æ½†
kcbc	æ¿›
kcmj	è±
kcmq	ç€
kcfl	æ¾¸
kcfq	æ¸›
kcfw	çŒ
kcfy	èŸ¸
kcdz	è±µ
kctm	æ¿­
kctt	æ¶¯
kcnb	ãµ
kcnd	æ¸¶
kcns	è± 
kclf	è±´
kclh	æ²¥
kclj	åŒ¶
kclq	ç€³
kclv	æ¿©
kcgl	è±Ÿ
kcgg	è±£
kcgq	ã³š
kcgv	è±­
kckp	æ¸«
kckm	æ¸®
kckf	æ¼¢
kckt	å Š
kckl	æƒ¡ æ‡£ æ‡‘
kckg	æ»¿ ç§ è±§
kckh	ç‡¹ æº€
kckj	æ³„ è±˜
kckq	éµ¶
kckc	è±©
kcks	æ¾•
kckr	æ»¡
kckv	æ¼Œ
kckw	ç˜
kcky	è
kchm	ç€
kchq	æ»…
kchx	æº
kchv	ç”¤
kcjf	æºš
kcjv	æ¹¹
kcqf	æ¸ƒ
kcqn	æ¼­
kcql	æ…
kcqj	åŒ¿
kcxb	æ½‡
kcxm	ç€Ÿ
kczd	è±¯
kczk	è±·
kccn	æ¿¿
kccx	è±²
kcsb	æ·‡ è±¶
kcsp	æ««
kcsl	æ¿
kcsj	æ¹›
kcsx	æ¾Œ æ¿
kcsr	è±¬ è±®
kcrm	è±±
kcrf	æ¿¸
kcrd	æ¼ 
kcrn	æ¾«
kcrr	æ¿—
kcvp	æ¢ ç²± æ¹ˆ ç¡
kcvf	æ»£
kcvd	æµ±
kcvg	ç”™
kcvq	æ¼˜
kcvc	æº½
kcwr	è±¥
kcym	ç†
kcyr	è±¨
ksbn	æµ¡
ksbh	æ¸¤
ksbx	æº¹
ksbr	å¸¦
ksmb	æº‘
ksmf	æ¹±
ksmj	æ»Ÿ
ksmx	æ½”
ksfm	æµº
ksft	æ¼Ÿ æ¾¢
ksfq	ç™
ksfw	ç‰
ksfy	æ¹– è™º
ksdp	æ·—
ksdj	åŒ¨
ksnf	æ·Œ
ksng	æ¹³
ksns	æ·”
ksld	æ¸
kskj	æ³¯
kskc	è±—
ksks	æ´¸
kskr	å¸¯ æ¹£
kshm	æ¼ª
kshf	æ¹‰
kshc	æ¶›
kshr	æ½´
ksjg	å¼
ksjj	å¼
ksjq	é´„
ksqn	æ¶
ksqj	æ´˜
ksqr	æ¸š
ksqw	æ¼–
ksxb	é ¸
ksxd	å‰„
ksxk	å· 
ksxh	å‹ å·°
ksxq	éµ›
ksxz	é€•
ksxv	æ·‘
kszd	é¿°
kszl	æ¼§
kszg	æ¾£
kszh	æ·˜
kszx	ç€š
kszs	æ¿£
kszy	æ½®
kscb	æ¿†
kscr	ğ£¸£
kssg	æ½ 
ksrp	æº± æ¼…
ksrd	æ¹Š
ksrn	æ·
ksrh	æ¿‡
ksrs	æº™
ksrr	æ¹·
ksvl	æ·´
ksvj	åŒ¢ åŒ«
ksym	å°¶
ksyn	æ´¶
krbb	æ··
krpq	é¶‡
krmf	æ¾·
krmv	æ¼«
krfx	æ¼Š
krtc	æº¡
krnq	é³¾
krlf	æµ›
krll	æ·°
krlg	æ³ 
krlj	æ²§
krgf	æ¶»
krgs	ç€‘ æ»­
krkm	ç›ª
krkd	åˆ¯ æ·
krkg	ç’—
krkh	ç‡™
krkc	æ·‚
krkv	æ¹¯
krhg	å…©
krhk	æ¹¿
krhv	æ¹¦
krjb	ç
krjr	ç
krxf	æ»„
krxn	ğ¬¸˜
krxj	åŒ½
krxq	é¶ 
krxx	æº»
krxv	éƒ¾
krsb	æ¸‡
krsj	æ¸´
krss	æ»‰
krsr	æ¿
krrb	é ° è³š é¡‚
krrp	ä¾† éº´ éº¬ éº³
krrm	æ¾€
krrf	éº©
krrn	éº° éº¶
krrl	æ„¸ æ†– æ†— éº§ éºª
krrg	éº±
krrk	éº·
krrh	å‹‘ éº¨
krrj	éº«
krrq	ç€¸ çŒŒ éµŠ é¶† éº¯
krrz	é€¨
krrs	éºµ éº­ éº²
krrr	å¤¾
krrv	éƒŸ éƒ²
krrw	éº¥
krry	éº®
krvy	æµ
krwy	æ¸‚
kryb	ç¦
kryd	å‰¸
kryl	æƒ 
kryq	æ¿• é·’
kryc	å°ˆ
kryv	ç”¦ éƒ  é„Ÿ
kryw	ç”
kvmb	æ¼¬
kvmg	è²³
kvfb	æ¿»
kvng	è´°
kvns	æ·¸
kvnr	æ¸
kvlh	æ³
kvlw	æ»©
kvgy	æº
kvkw	æ½
kvjp	æ»
kvjg	å¼
kvqm	ç€
kvqj	æ¿ª
kvqz	ç€¡
kvxk	æ³¾
kvzm	æ»¥
kvvb	ç
kvvp	ç€¾ æ¾–
kvvf	æ¿¶
kvvs	ç ç›
kvvr	æ¾—
kvvv	æ¶°
kvvw	æ½¤
kvvy	æ½£
kvwv	æ¼‹
kvyx	æº¸
kwbm	æ¸Ÿ
kwbt	æ¹¸
kwbc	æ¿ 
kwmd	ç€¤
kwfd	ç€¼
kwdv	æ¿Ÿ
kwtl	ä¹¼
kwtj	åŒŸ
kwnf	æ»ˆ
kwlm	æ¶¥
kwln	æ·³
kwlv	æ¼·
kwlw	æ¶² æ½¡
kwgj	åŒ¤
kwkv	æ¹°
kwhp	æ»¦ æ¾Ÿ
kwhd	æ¹™
kwhg	æ¹¾
kwhk	æ¾¶
kwjh	åŠ»
kwjv	é‚¼
kwqm	æ´š
kwzs	æ»¸
kwsm	æµ²
kwsz	æ¼¨
kwrd	æ»–
kwrx	é¿Œ
kwrs	æ·¬
kwvw	æ¾­
kwwb	æ¿
kwwj	æ½–
kwyp	ç¤
kwyf	ç€› çœ
kwyd	æµ
kwyt	æ»€
kwyn	æ¼“
kwyg	ç£ ç‘¬
kwyh	æµ
kwyj	é
kwyq	æµ æ·¯
kwys	ã³˜
kwyv	æ¸ˆ
kwyw	æ¾ˆ ç•
kybw	æµš
kypp	ç€®
kypm	ç€
kymj	æ·
kyds	æ¸—
kydv	æ¿¡
kytp	è‡»
kytf	è‡µ
kytd	åˆ°
kytt	è‡¸
kytn	è‡¶
kytq	è‡¹ éµ„
kytv	éƒ…
kytw	è‡´
kynj	åŒ¥
kylh	æ³‘
kylw	ç€–
kygg	æ·º
kygy	ç
kykj	æ¶„
kyks	æµ‡
kyhn	æ´ 
kyjb	æ¬§
kyjn	é¸¥
kyjq	é´
kyjs	æ®´
kyjw	ç“¯
kyqq	æ·†
kyqr	æµ 
kyzm	æ¿«
kyzf	ç€¶
kyzd	æ¶˜
kyzs	ç 
kysv	æ¹©
kysw	æ¿°
kyrg	æ¾ª
kyvy	æ¾
kyyg	æˆ©
kyyq	é·
kyys	æ»²
kyyr	çˆ½ æ™‰
hbbg	ç„ª
hbbk	å´† ç„¢
hbbr	ç…¯
hbmb	å·“
hbff	ç†
hbdx	çˆ
hbkm	ç¿
hbkt	å£‘ å£¡
hbkk	ç…Š
hbkz	ç…‡
hbkv	å¡
hbhq	çƒ¢
hbhw	æ•¹
hbjj	ç„¥
hbjy	åµ¬
hbqy	å³µ
hbzz	å¶·
hbrl	ç†
hbvx	å´‡
hbvs	çƒ·
hbyl	ç„§
hbyx	åµ¡
hpbb	ç§• ç©¦
hpbd	ç§¾
hpbg	ç©ƒ
hpbq	ç§º
hpbx	ç¨…
hpbc	ç¨¼ ç§
hpbr	ç¨­
hpby	å´§
hppg	ç§«
hpps	è™¨
hpmg	çƒ
hpmq	ç©¢
hpfm	ç§
hpff	ç¨†
hpfl	æƒ’
hpfw	ç¨‹
hpdp	æ¢¨
hpdd	ç¨¬
hpdn	çŠ ç§š
hpdl	æ‚¡
hpdk	ç§ 
hpdh	ç¨Š ç¨´
hpdj	é‹«
hpdx	ç¨ é¿Ÿ
hpdz	ç©Ÿ
hpdy	ç¨µ é¿ 
hptb	é ½ ç©¨
hptt	ç¨‘
hptg	ç©“
hptq	ç¨© éµš
hptc	ç§²
hpts	ç©˜
hptr	é¢“
hptw	ç¨œ ç¨·
hpnb	é º
hpnf	ç¨ 
hpnd	ç§§
hpnk	ç§µ ç¨‡ ç¨’ ç¨›
hpnq	ç©’
hpnz	é€
hpns	ç§Ÿ
hplp	ç©•
hplm	ç¨¦
hplf	ç¨–
hpld	ç©£
hpln	å­£ ç§„
hplq	ç¨° ç©› ç©®
hplz	ç§¹
hplv	ç©œ
hplw	ç¨š
hpgb	ç§œ ç©” ç©¬
hpgn	ç©‰
hpgg	ç¨‚
hpgx	ç¨º
hpgc	ç¨¨
hpgs	ç©…
hpgr	ç¨“
hpkt	ç§· ç¨«
hpkl	ç©— ç©‚ ç©²
hpkg	ç§¿ ç¨¶
hpkk	ç¨
hpkj	ç§¬
hpkq	ç¨¢
hpks	ç§¤
hpky	ç¨‰ ç©ª
hphb	ç©³
hphp	ç§
hphf	ç§© ç§¥ ç§³ ç©™
hphn	æ« é¹™
hphl	æ„
hphg	ç§½
hphk	é¾
hphh	ç§­
hphj	é«
hphq	ç§… é¶–
hphx	åª
hphs	ç©† æ¹¬ ç§Š
hphv	é†”
hphw	ç”ƒ
hphy	èµ
hpjb	ç©¥
hpjp	ç¨Œ
hpjf	ç§´
hpjl	ç¨³
hpjg	ç§»
hpjj	ç©
hpjx	ç§° ç©„
hpjc	ç¨
hpjs	ç©Š
hpjr	ç© ç©­
hpqd	ç© 
hpqg	ç§¡
hpqh	åµ‡ åµ†
hpqr	ç¨½ ç¨¥
hpqw	è«¬
hpxn	çŠ©
hpxg	ç§ª
hpxh	ç§’
hpxj	ç§–
hpxz	é€¶
hpxs	ç©‹ è¦£
hpxw	ç“¾
hpxy	é­
hpzf	ç§¸
hpzt	ç¨±
hpzn	ç¨ƒ
hpzl	ç©© ç©
hpzj	ç¨»
hpzc	ç©±
hpzs	çˆ©
hpzr	ç¨²
hpzv	ç§¨
hpzw	ç¨ª
hpcb	ç¨˜
hpch	ç©
hpcv	ç©«
hpsb	é ¹
hpsp	æ£ƒ
hpsm	ç
hpsf	ç§™
hpsd	ç¨§
hpsn	çŠ‚
hpsh	ç©‘ ç©¡ ç©¯
hpsj	éŒ…
hpsq	ç¨ é»§ é¯¬ éµ¹
hpsz	é‚Œ
hpsc	å‰“
hpss	é» ç¨™
hpsv	ç§“
hprb	é¦œ é¦ é¦© é¦ª
hprp	ç¨
hprm	é¦§
hprf	é» é¦  é¦¡
hprn	é¦ é¦Ÿ é»
hprl	ç¨”
hprg	ç¨ˆ ç§¢ é¦› é¦¢
hprk	åµ–
hprh	é¦¦
hprj	é¦£ é¦¤
hprc	é¦š
hprs	é»
hprr	é¦«
hprv	ç©
hprw	é¦¥
hpvb	ç©
hpvs	ç§‘
hpvy	ç§
hpwf	ç¨¿
hpwd	ç©°
hpwt	åµ€ ç§” ç¨¸
hpwn	ç¨•
hpws	ç¨¡
hpwv	ç©§
hpyf	ç§® ç©š
hpyg	å¶˜
hpyq	ç§ ç©–
hpys	ä…Ÿ ç©‡
hpyr	ç¨€
hpyv	ç¨® ç©¤
hpyw	ç¨„ ç¨¯
hpyy	ç¨
hmbf	è‡±
hmbd	å´±
hmbx	å·Š
hmbz	é‚Š é‰ é‚‰
hmpj	è‡²
hmpq	é·
hmpw	ç”ˆ
hmmw	çˆ 
hmdb	è‡°
hmdn	è¡…
hmdg	è¡ƒ
hmtd	åŠ“ é½ˆ é½‰
hmtt	çˆ…
hmtn	é¼»
hmtl	é¼½
hmtg	é¼¾ ç¾ å¶§ ç‡¡
hmtk	é½„
hmtj	é½ é½ƒ é½†
hmtq	é½…
hmts	é¼¼ é¼¿ é½‚ é½‡
hmtw	é½€
hmlt	è¡„
hmlr	è‡®
hmlv	é„
hmgd	è¡‡
hmkh	è¡ˆ
hmhn	ç¾‹
hmjl	é¼‘
hmqv	é„“
hmcq	è¡Š
hmst	åŸŠ
hmsq	é·±
hmsx	ç¿º
hmss	è‡¯
hmsr	å´‰
hmsy	ç‡­
hmwf	è¡‰
hfmb	ç†‰
hfms	è¦˜
hffp	ç‡¥
hfff	åµ“ ç…°
hffj	å´¿
hffs	ç‡€
hffw	å·– å·—
hfdb	é •
hfnq	é´©
hfnv	é„…
hflh	åŠ®
hflw	å¶‰
hfkd	è™
hfkq	å¶¯ é¸†
hfzj	å´º
hfsg	å…
hfvp	æ¢·
hfyg	æˆ˜
hfyy	çˆ
hdpm	å¶™ ç‡ é£œ
hdpt	ç•ª
hdpn	é‡Š ğ¬¸ª
hdpl	æ‚‰
hdpg	é‡‹ é‡ˆ
hdph	å‹«
hdpq	é·­
hdpx	ç¿» åµ
hdpv	é„±
hdpy	é‡‰
hdmb	ç…© å´¸
hdmg	ç‚‹
hdmk	å²¯
hdmr	å¶’ ç†·
hdmw	å·
hddx	ç‡ å¶š å¶›
hdds	ğª¨¶
hdtt	ç…ƒ
hdtc	å´»
hdnb	é¡“ æ­‚
hdnd	å‰¬ ç…—
hdnl	ä¹¯
hdnz	é„
hdnr	çƒ¦ é¢›
hdnv	å³ è€‘
hdlb	ç‚¼
hdgh	ç„
hdkm	å´
hdkd	çƒª
hdkn	çƒŠ
hdkk	åµ¯ åµ³
hdkh	åµ° ç†‘
hdkx	å·•
hdkz	ç‡§ è¼‹
hdkc	ç…«
hdkw	å·™
hdky	åµ«
hdhw	å¶¶
hdjb	é «
hdjd	å…†
hdjq	é´µ
hdjz	é€ƒ
hdjs	è¦œ
hdjr	ğ«–¯
hdjv	é¼—
hdxn	åµ‚
hdxc	å¶Ÿ ç‡‡
hdxv	å´· ç…ª
hdsx	å´­
hdrj	å´¦
hdrz	åµ· åµ¸
hdrs	ğ¬Š¤
hdvm	çƒ†
hdwd	åµ„
hdwq	å¶¬ ç‡¨ çˆ”
htbw	å´š
htmb	é¡±
htmq	é¸•
htms	è¦¤
htfb	é ¶
htff	é 
htfn	é¹„
htfh	å‹‚
htfq	éµ 
htfz	é€ 
htfv	éƒœ
htdz	ç‡µ
httc	å´¶
htts	ç‡’ å¶¢ å¶¤
htlh	è™œ å‹´
htlq	å¶» è™ª
htkd	ç…¨ åµ”
hthb	è´™
htht	è™¤
hthh	çˆ€
hthy	åµ ç…ˆ
htcv	ç”
htsb	è´Š
htsd	åŠ—
htsz	é€‰
htss	å…Ÿ
htsr	èµ
htsv	è™ é…‚ é…‡
htym	ç††
htyg	è™¥
hnbf	çƒ± çŠ—
hnbn	ç‰¸
hnpk	ç„‘
hnmb	çŠ¤
hnmq	çŠ‘
hndm	çŠ„
hndd	å¥¥
hndl	ç…¾
hndk	çƒŸ
hndh	å´— å¶´ ç„µ
hndj	ç‰  ç²¤ ç„¹ çŠˆ
hndq	çŠ§ çŠ 
hndw	çŠª
hntb	é¡œ
hntj	è§
hntz	é˜
hntc	ç‰¹
hnts	æ–  è¦¯
hnnb	çŠ‹
hnnk	ç‰­
hnnh	çŠ…
hnlf	çŠƒ
hnlh	ç‰
hnlq	çŠ¥
hnlv	çŠ
hnlw	å¶Š
hngn	çŠ•
hngk	å£
hngz	é€Œ
hngc	çŠ
hngv	çŠŒ
hnkm	ç‰±
hnkk	é¾œ ç‰¼
hnhf	ç‰¿
hnhd	å¥§
hnhn	ç‰ª çŠ‡
hnhh	ç‰¬
hnhj	ç²µ
hnhs	çŠ
hnhv	ç‰²
hnjg	ç‰³
hnqp	çŠ”
hnqn	é¹…
hnqg	ç‰»
hnqq	éµ éµ
hnxf	ç‰¾
hnxg	ç‰´ çŠ
hnzb	çŠ¢
hncb	æ¬³
hncn	çŠ¡
hnsp	çš» é¿¯
hnsf	ç‰¯
hnsd	çŠŠ
hnsl	æƒ£
hnsk	å´® å´“
hnsh	çŠ“
hnss	çŠ† è¦°
hnsv	ç‰©
hnsy	çŠ£
hnrm	ç†…
hnrs	çŠ¦
hnvk	å›ª å¥
hnvq	ç„¨
hnwf	çŠ’
hnwt	ç‰¨
hnwn	çŠ‰
hnwl	æ‚¤
hnwk	å›±
hnwj	ç‰¤
hnws	çƒ¿
hnww	çŠœ
hnyb	é¡–
hnyf	çŠ
hnyn	ç¦¼
hnyl	æ– é¹¶
hnyg	ç‰« é¹·
hnyk	å¤ å›Ÿ é¹¾ é¹µ é¹º
hnyh	é¹»
hnyq	é¹¹ ç‰¦
hnys	çŠ™
hnyr	é¹¼ é¹¸
hlbf	åµ­
hlbs	çƒ¨
hlbr	å´¹
hlpw	é›‘
hlmn	å´¡
hlmw	å³³
hldb	é „
hldm	é¦—
hlnf	ç†µ
hlnq	é³©
hlgp	ç…£
hlgf	ç‡
hlgk	ç‡ˆ å¶
hlgz	ç†¥
hlkb	å·ƒ å·„ çˆ–
hlkm	åµœ
hlkf	ç„™ ãŸƒ
hlkl	ç‡±
hlkq	ç†¾
hlkz	å¶‚
hlkv	ç‡‘
hlhb	ç‡²
hlhd	å³
hlht	è™“
hlhq	ç†
hlqn	é½¾
hlcs	åµƒ
hlcv	åµ¼
hlsm	ç…’
hlwf	å·‚
hlwn	å¶²
hlwj	è™§
hlwq	å¶• å¶£ ç‡‹
hlwv	é……
hgms	æ±†
hgmv	ç…†
hgmy	çˆ¥
hgfy	åµ¹
hgdp	ç±´
hgdd	åµ¶
hgdh	ç‡«
hgdr	é¢…
hgdw	ç³´
hgnl	ç„–
hgnq	é³°
hglf	ç„—
hglg	ä¹
hglq	é´”
hggb	çˆŒ
hggj	ç†©
hggx	ç…½
hggc	ç…¸
hggv	çƒ¬
hgkv	å…ª
hghg	å¹·
hghz	é€¬
hghw	ç”
hgxb	ç„®
hgxf	åµ£ ç…»
hgxs	åµ»
hgxr	ç„¿
hgcq	ç†«
hgsp	å·ˆ
hgsf	å´Œ
hgvc	å¶
hgyb	ç†¿
hkbg	é»» é»¼
hkbc	é»º
hkmb	åµ¿
hkmp	ç…‰
hkfb	é¡—
hkfp	æ•±
hkfm	å²¢ ç‚£
hkfd	å‰´
hkft	å‡± ç…
hkfg	æˆ²
hkfk	è±ˆ
hkfj	å¶‡ ç†°
hkfq	çƒ
hkfs	è¦¬ è¦»
hkfw	æ•³
hkfy	é¢½
hkdp	å´ƒ ç³³
hkdf	è
hkdd	å³¡
hkdn	å‡¿
hkdl	æ‡Ÿ
hkdg	ä¸µ
hkdj	é‘¿
hkdq	é¸ˆ
hkdc	å°
hkds	å²¼
hkdv	å¢ é„´
hkdw	æ¥­
hknj	ç‚–
hkgd	å½‚
hkgj	ç‚¬ å² 
hkgs	å´‹
hkgr	å³“
hkqg	å³¬ çƒ³
hkqc	ç…¿
hkqr	å¶†
hkxg	çƒ’
hkxz	å´¨
hkzx	å¶„ å¶ƒ
hkcd	åŠ‡
hkct	å¶³
hkch	å‹®
hkcz	é½
hksk	çƒ´
hksr	ğ«¶‡
hkrp	å´ å´  å´¬
hkrk	å³˜ çƒœ
hkrr	å³½
hkry	å³º
hkyt	å³Œ
hkyj	å²– ğ¬‰¼
hhbp	æ¦® æª¾
hhbf	ç‡Ÿ
hhbd	è¤®
hhbt	å¡‹ ç„­
hhbn	çŠ–
hhbl	æ†¥
hhbg	ç‘©
hhbh	å‹ åµ¤ ç†’ ç½ƒ
hhbj	é£
hhbq	é¶¯ è†‹
hhbx	ç¸ˆ å«ˆ ç¦œ
hhbs	æ» ç…¢ è¦®
hhbv	é†Ÿ
hhbw	ç”‡ è¬
hhby	è¢
hhpd	å³²
hhpg	ç†ª
hhph	ç…
hhpx	å´£
hhps	åµ™
hhpy	å·
hhmp	åµ²
hhml	ç†„
hhms	è¦¢
hhdb	æ­‘ é¡ƒ
hhdd	çƒ‘
hhdt	ç‡” å¶“
hhdn	çƒ€ è™–
hhdv	ç…“
hhtb	å·‘
hhtm	çˆ
hhtf	ã¸† å³¼ ç„…
hhtl	çˆˆ
hhts	çƒ
hhnd	ç‡ 
hhnt	ç…¹
hhnl	ç†œ
hhnq	å³¨ å³© é¶‘
hhnw	ç‚¿
hhlq	å·˜ å·š
hhlw	ç†£
hhkb	æ­” è™¡
hhkg	å·‡ æˆ¯
hhkk	åµ¦
hhkj	è§‘
hhks	è¦·
hhkv	çˆœ
hhkw	å¶ª å¶«
hhhb	æ­˜
hhhp	å¶¸ ç‡Š çˆƒ
hhhf	å·† ç…”
hhhh	å¶— ç‡š
hhhy	é£Š
hhjp	ç‡¦
hhjg	çˆ˜
hhzg	çƒ¶
hhsk	å´œ
hhsr	åµŠ
hhrb	ç†´
hhrp	çˆ
hhrw	ç…Œ å´² ç‡©
hhvx	å¶­
hhvr	å·‹
hhwb	é¡²
hjmd	ç…¥
hjmr	ç‡´ ç„”
hjft	å·‰
hjfx	å¶– ç†»
hjfc	çˆš
hjfr	å¶®
hjdr	ğ«–®
hjnd	ç„•
hjnc	å´™ å´˜
hjgp	ç²² åµ¥
hjgd	åˆ¿
hjgg	é¤
hjgk	éŸ°
hjgx	ç¿™
hjkb	å¶¼
hjks	ç……
hjqd	åµ› å´³
hjqg	ã ‡
hjxm	å³¥
hjxs	ç‡¬
hjcn	å¶°
hjcj	å³— å³
hjcw	å¶¦
hjsk	å´„
hjvq	ç‡ƒ
hqmh	å²ˆ
hqmv	å³«
hqdp	ç†‚
hqkb	èº° è»‰
hqkp	èº² èº± èº¶ èº¹
hqkm	èº¸
hqkf	èºº èº³
hqkd	èº¼ èº¾
hqkl	èºµ è»ˆ
hqkg	èº¬ èº´
hqkk	èº» è»†
hqkh	èº« è»‚
hqkj	è»€ èº¯ èº½
hqkq	è»„ éµ¢
hqkx	èº· è»
hqkc	å°„ èº® è»‡
hqks	èº­ èº¿ è»ƒ
hqkw	è»…
hqcd	å¶© ç‡¶
hqsr	å¶œ ç†¸
hqvg	ç‚¦
hqvr	åµ½
hxmm	ç†½
hxng	ç…¡
hxlf	ç„ å³¿
hxlg	å·€
hxlw	ç†¦
hxkb	ç†•
hxhf	å³®
hxjg	å²»
hxjr	å´ ç„
hxxk	ç†¤
hxxc	ç‡–
hxxs	åµº ç†®
hxxr	ç†  å¶
hxxw	ç‡¿
hxsm	ç‡¼
hxvx	ç†›
hzbw	ç‡°
hzmc	çˆ
hzmv	ç‚¸ å² å²
hzff	ç†º
hzdb	å·”
hzdj	ç‚§
hzdr	å·…
hznq	éµ«
hzlb	é ²
hzln	çƒ°
hzlg	å»· çƒ»
hzlc	å¶¹ ç‡½
hzlr	é¢‹
hzgv	åµˆ ç…–
hzjg	çƒ¸
hzxm	å´¢
hzxl	å¶¾
hzzh	ç†
hzyd	åµ 
hcbp	åµ˜
hcbh	å´‚
hcbc	ã “
hcmq	åµ—
hcfq	åµ… ç…˜
hcfw	å· çˆŸ
hctt	å´– å´•
hcnb	å¶¡ å¶¥
hcnd	ç…
hclh	ğ«µ·
hclq	å³¸ çˆ‘
hclw	åµŸ
hckp	ç… 
hckf	ç†¯
hckg	æˆ±
hcks	ç‡
hchm	çˆ
hcxj	å¶
hcxq	å´´
hccn	å· çˆ„
hcsl	ç‡ª
hcsj	åµ ç…
hcsx	ç‡
hcrn	ç‡¤
hcrj	å¶±
hcry	çˆ¡
hcvb	åµŒ
hcvp	ç…¤ çˆ¤
hsmb	ä¹–
hsmd	å‰©
hsmr	ä¹˜
hsmv	åŸ€
hsfb	é ¢
hsff	èˆ™
hsfd	åˆ®
hsft	èˆ‘
hsfn	é¸¹
hsfl	æ†© æ†‡
hsfh	èˆ•
hsfj	ä¹± èˆ
hsfq	çˆ£ é´°
hsfx	è¾
hsfz	é€‚
hsfs	èˆ” èˆ
hsfr	é¾¦
hsfv	ç”œ èˆ“
hsfw	æ•Œ èˆš
hsfy	ç…³
hsdc	å¶ˆ
hsng	ç…µ
hsnh	ç…¼
hsnq	ğª©˜
hsny	çˆ‰
hslb	ç‰Œ ç‰˜
hslp	ç‰’
hslm	ç‰—
hslf	ç‰ˆ ç‰Š ç‰“
hsld	ç‰ ç‰
hsln	ç‰‰
hsll	ç‰ ç‰•
hslg	ç‰– ç‰‹
hslj	ç‰
hslc	ç‰‘ ç‰”
hsls	è¦‘
hsgk	å‚
hsgv	éƒµ
hsgw	ç”€
hskj	å²·
hshq	å¶½
hsjb	æ­ƒ
hsjp	æ•®
hsqj	çƒ¤
hscb	ç‡Œ
hscs	ç„¼
hscw	å·Œ
hsrq	åµ´
hrbb	å´‘ å´ ç„œ
hrbd	å½ çš
hrbt	å¢
hrbk	æ›
hrbs	æ—£ çš–
hrby	é­„
hrmb	çš‰
hrmj	çš…
hrms	æ³‰ å…  ç¥
hrmv	ç†³
hrfq	é¸„
hrfx	å¶ ç†¡
hrfz	é‚€
hrfw	æ•« è­¥
hrdk	çš
hrdq	é·
hrdx	ç¿±
hrds	çš‹
hrtc	åµµ
hrts	çš¢
hrnf	çš—
hrlb	å¶º
hrlf	ç„“
hrll	ç„¾
hrlg	å²­ å²º å»¹ ç‚©
hrlk	ç…œ
hrlh	åŠ°
hrlj	ç‚
hrlq	çš«
hrls	å…œ
hrly	çš
hrgs	çˆ† ç†š
hrkv	ç…¬ å´µ ç†¶
hrhp	çšª
hrhf	çš“
hrht	çš¤ çš¨
hrhn	ç„º
hrhk	çšš
hrhj	çš‘
hrhq	çš’
hrhs	çš çš¡ çš¥
hrhr	çš›
hrhv	ç…‹
hrhw	çš  çš¦
hrxf	åµ¢ ç†—
hrzc	çš­
hrzw	çš§
hrcq	ç‡³
hrcs	çˆ— çš£
hrsp	æ¥½
hrsj	åµ‘
hrsx	ç¿¶
hrss	ã¿  ç†€ çš
hrsv	ç„¬
hrrg	çšŠ çš”
hrrx	ç·œ
hrvb	çšŸ
hrvq	çš˜
hrvy	çƒ©
hrwf	çšœ
hrwz	é‘
hrws	çš çš©
hryp	æ¨‚
hryw	çš¬
hvmr	æ­¸
hvfy	è›—
hvdb	é §
hvth	ç”¥
hvnq	é´­
hvkr	å¸«
hvhq	ç”§
hvhv	ç”¡
hvxk	çƒƒ
hvsb	é¡Š
hvvp	çˆ›
hvvl	ç‡œ
hvvj	çˆ“
hvvr	ç†Œ
hvvy	ç‡— ç‡˜
hvwv	å¶
hwbm	åµ‰
hwbt	ç…·
hwfd	çˆ™
hwnp	ç‡º
hwnf	åµ© åµª ç†‡
hwnn	å·
hwln	å´ ç„
hwlw	ç‡‰ ç„²
hwhp	ç‡£
hwhx	ç‡·
hwsm	å³° çƒ½ å³¯
hwsz	ç†¢
hwrs	å´’ å´ª ç„ 
hwyq	ç„´
hwyr	å³ çƒ—
hybb	èˆ­
hybw	å³» ç„Œ
hyby	èˆ©
hymh	çˆ‹
hymj	èˆ¥
hymq	ç‡»
hyfm	èˆ¯
hyff	å¶  ç‡†
hyfk	çˆ§
hyfq	è‰¥
hydm	è‰ è‰—
hydg	èˆ¦
hydk	è‰–
hydj	èˆ¿
hydq	è‰¤
hydv	å¶¿ ç‡¸
hytf	èˆ¹
hynm	è‰’
hynq	éµƒ
hynw	åµ åµ•
hylm	è‰‹
hylf	è‰•
hylk	è‰ 
hylh	å²°
hylv	è‰Ÿ è‰­
hylw	ã¸Œ
hygf	è‰
hygg	èˆ® è‰†
hygq	è‰‰
hygc	è‰‘
hygv	è‰”
hygy	èˆ£
hykm	èˆ¸
hyks	çƒ§ å³£
hykr	è‰š
hyhm	è‰«
hyhf	è‰
hyhg	è‰‡ èˆ» èˆ§
hyhh	è‰£
hyhr	èˆ¶ è‰Š
hyhw	è‰
hyjp	è‰…
hyjt	è‰¬
hyjr	è‰ª
hyjv	è‰˜ è‰ƒ
hyqj	èƒ¤
hyqq	å´¤
hyqr	çƒ¯ è‰œ
hyxk	èˆ¡
hyzm	çˆ
hyzd	è‰
hyzn	è‰€
hyzs	çˆ¦
hyzv	èˆ´
hycp	è‰“
hycc	è‰¨
hycv	è‰§
hysp	æ§ƒ
hysm	ç›¤
hysf	ç£
hysd	è¤©
hyst	è‰¡
hysn	æ«
hysg	é¶
hysh	è‰¢
hysj	éœ
hysq	è‰„ ç†ˆ
hysx	åª» ç¸
hysr	å¹‹
hysv	ç…„
hysy	èŒ
hyrf	è‰™
hyrl	è‰Œ
hyrg	ç‡¯ èˆ²
hyrj	èˆ±
hyrx	è‰›
hyvt	ç†
hyvj	å¶€
hywm	èˆ½ è‰‚
hywt	èˆª
hywh	è‰ˆ
hywv	è‰©
hywy	èˆ·
hyym	è‰¦
hyyd	å‰»
hyyx	è‰
hyys	åµ¾
hyyw	è‰
jbbr	è° é‡
jbby	é‘¹
jbmb	é­
jbds	è¯¨
jbns	è°Š
jblm	é‘
jblr	é¥
jbkb	é” é‘Œ
jbkk	é¹
jbkz	é•
jbkc	éµ
jbhq	è¯§
jbhz	é‘³
jbjj	é‹º
jbjx	é‘”
jbqy	é‹
jbcg	é‘§
jbsf	é‹
jbvx	éŒ
jbvs	é‹
jbyx	é“
jplw	é›“
jphh	åµ
jpvd	å
jpvt	ã™¦
jpvs	æ–œ
jpyn	é‘»
jmbd	é˜
jmmv	é’
jmmw	é‘º
jmtg	é¸
jmkm	é 
jmkd	é¶ ğ«½
jmjl	é¤
jmcq	é¬
jmsm	ç›¥
jmsr	éŒ”
jmsy	è§¸ é²
jmrb	æœ‡
jmrd	åŠŠ
jmrn	é‘¡
jmrv	é„¶
jmvb	é‰³
jmvz	éš
jmvv	é„‹
jmyw	é‘¼
jfbd	åŠ–
jfbt	æ¯š
jfbv	é…
jfpm	æ¨–
jfmf	é´
jffb	æ­› é‘š é¡© é¾¡ é¾¥
jffp	é° é¾¢
jffm	é‹›
jffd	åŠ
jffg	åŠ”
jffj	è°” é”
jffq	é¸™
jffc	é¾  åŠ
jffs	è§¶ é¾£
jffr	åƒ‰ åŠ’ éŸ é¾¤
jffw	æ–‚
jfdb	é œ
jfdr	é¢Œ
jfnn	æ»
jfnq	é´¿
jflb	é¾•
jfkd	è¯¯ é‹˜
jfkh	é“
jfqg	é¾›
jfxb	æ­™
jfxm	ç›«
jfxx	ç¿• ç¿–
jfzd	éƒ
jfzj	é¦
jfzz	é‡
jfsb	é€
jfsz	è°´ é‘“
jfrd	å‰£
jfrr	å‰±
jdbb	è¢•
jdbf	è°˜
jdbg	è¤£
jdbz	è¤Œ
jdbc	è¡¯
jdbs	è¡´ è£ˆ
jdbw	è¥’
jdby	è¡³
jdpm	é»
jdpn	è¥»
jdpx	è¥Ÿ
jdpz	è°œ
jdps	æ¯‡
jdmb	è¥¬ é¡‰
jdmg	è¡¥ è¥— éˆˆ
jdmk	é‰Ÿ
jdmq	è¤™ è¤ƒ
jdms	éŠ”
jdmr	é³
jdmw	å¤“
jdmy	è¥¡
jdfp	è¥™
jdfm	è¡¶
jdfj	éŒˆ
jdfq	è£
jdfs	è¥Œ
jdfw	è£
jddm	è£„ è£¿
jddf	è¢¥
jddn	è¢¢
jddk	è¤¨
jddj	è¡ª è¢´ è£· è£º
jddx	è¤› è£ é
jddz	è£¢ è¤· è¥š
jdds	è¤
jddr	è¢¹
jddv	è¢»
jdtd	è¤¤
jdtt	è¢¿ é·
jdtg	è¤‚
jdtq	è¥¶
jdts	è¥“
jdtw	è£¬ è¤¹
jdty	è¢ª
jdnf	è£¯
jdnt	è¢¡
jdng	è¡±
jdnk	è£€ è£
jdns	è¢“
jdnv	è¡»
jdnw	è¢‡
jdlb	è¥±
jdlp	è¤“ è¥
jdlm	è¤˜
jdlf	è¥¥
jdld	è¢‚
jdlq	è¢±
jdlz	è¢µ
jdlc	è¢
jdls	è¥¯ è¥
jdlr	è¤…
jdgp	è¥•
jdgm	éŠ‚
jdgf	è£¾
jdgt	è¤«
jdgh	éŠ»
jdgz	è¤² è¤ª
jdgc	è¤Š
jdgs	è£¤
jdgr	è£¥ è¤¯
jdgy	è¥
jdkb	è¥°
jdkp	è¥‹
jdkm	è°¥ è¢” è§­ éŒ¡ é°
jdkf	é¥
jdkd	é†
jdkt	è¤”
jdkn	è¯¦ è¡§ è§§
jdkl	è¥¹
jdkg	è£œ è£²
jdkk	è£‹ éˆ
jdkh	è°¦ è¥µ éŒ
jdkj	è¤—
jdkq	è£“
jdkx	è¤„
jdkz	è¤³ é¹ é©
jdkc	è°«
jdkr	è°± è£Œ è¤¿ è¥« é 
jdky	è¥§ é¡
jdhb	è¥¸
jdhm	è£‡
jdhf	è¢Ÿ è¢© è¥†
jdhd	è¥–
jdht	è£­ è¤  è¥
jdhn	è¥£
jdhh	è£‘ è£§
jdhz	è¡½
jdhc	è¥¨
jdhr	è¢™
jdhv	è¤
jdjf	è¢·
jdjd	è¤•
jdjn	è¥·
jdjg	è¢¯ è¢³
jdjk	è££
jdjc	è¤–
jdjr	è¥˜ è¥
jdjv	è£¡
jdjw	è¥œ
jdqm	è£«
jdqd	è¥›
jdqn	è¢¸
jdqg	è¢š
jdqk	è¢
jdxf	è£™ è¢½
jdxg	è¢›
jdxj	è¡¹
jdxx	è¤¾
jdxc	è¥‘ é
jdxs	è¤¼
jdxr	è¤¶
jdzb	è¥© è¥­
jdzf	è¢º é¿‹
jdzj	è¢˜
jdzx	è¢®
jdzv	è¤‘
jdzw	è¤‡
jdcb	è¤€
jdcp	è¤‹ è¥½
jdcf	è¤¡ è¢‘
jdcd	è¯¼ è£–
jdcg	è¥”
jdcj	è¢£
jdcq	è¥ª
jdcc	è¤¥
jdcy	è¥º è¥¼
jdsb	èˆ†
jdsd	è¢€ è¤‰
jdst	è¥ 
jdsn	éŒ›
jdsg	è¥ˆ
jdsh	è£ª
jdsx	è£† è£ƒ
jdss	è¢ éŒ“
jdsr	è¤š
jdsv	è¡¼
jdrb	è£©
jdrp	è£¸
jdrm	è¤
jdrl	è¡¿
jdrg	è¢Š
jdrk	è¢’
jdrj	è¤
jdrq	è¡¸ è¥³
jdrx	è¤¸ è¤Ÿ
jdrz	è¤† é¦
jdrs	è§¯ è¢— è¥… è¥®
jdrr	è£®
jdrv	è£¼ è¥Š
jdvb	è¥€
jdvp	è¤¬ è¥´
jdvm	è¤´
jdvd	è£± è¢†
jdvg	è¡©
jdvj	éŠ™
jdvx	éŒ¼
jdvr	è¥‡ ğ«Œ€
jdvv	è£°
jdvy	è¥‰
jdwm	è¢¶
jdwf	è¢¼
jdwd	é‚
jdwn	è¤µ è§²
jdwk	è¥¢
jdwh	è£—
jdwy	è¢¨
jdyb	è¤¦
jdym	è¥¤
jdyh	è¢
jdys	è¥‚
jdyv	è¥¦ è¤ˆ
jtbt	éŒ´
jtbw	è°¡ éŒ‚
jtfd	é±
jtfq	éµ é¡
jtdz	é½
jttt	é‘˜ é‘¸
jtts	éƒ
jtlh	èˆ…
jtkd	é¡
jtjb	èˆˆ
jtjg	ç’º
jtjh	çˆ¨ çˆ‚
jtjq	è‡–
jtjc	é‡
jtjs	èˆ‹
jtrq	é…
jtym	é‘
jtyx	é
jndk	éŠ¦
jndh	é‹¼
jndj	é¾¬
jntf	è°ƒ éŒ­
jnnk	éŠ
jngb	éŒª
jnsg	è§© éŠ¶
jnsk	éŒ®
jnsh	é‹¤
jnrw	å¤ æ•»
jlbf	è°¤ éŠ
jlbr	è°› é—
jlmq	é…
jlms	é€
jltd	ä¾´
jlnm	éŒ³
jlnf	è°ª é‘
jlnq	éµ‹
jlld	é­
jlgp	é’
jlgf	è°² é
jlgd	é¨
jlgn	è¯µ éŠ¿
jlgk	é™
jlgs	éº
jlkb	å½˜ é‘¨
jlkp	å½™
jlkm	ç› 
jlkf	è¯ é‰° éŒ‡
jlkd	å‰ å‰¶ åŠ™
jlkn	å½ å½œ
jlkl	é¿
jlkq	é¶¨
jlkz	é±
jlkc	å½–
jlks	é¡ å½”
jlkr	è°™
jlkv	é˜
jlky	è ¡
jlhf	é‰«
jlhd	é‰š
jlhz	éŠ‹
jlzq	è°
jlcs	è°š
jlcv	éŸ
jlsb	è²«
jlsm	é
jlsz	é¦
jlsr	è´¯
jlvs	è§® éŒ²
jlwp	é¶
jlwd	è¢°
jlwn	è§¹ é¸ é«
jlwg	æ¯
jlwj	æ¯‘
jlwq	è°¯ é
jlws	é¨
jgbb	å¤¤
jgbz	ç¦ˆ
jgmb	å¤
jgmg	å¤– é‡½
jgmq	ç¦™ ç¦¡
jgmx	ç¦¤
jgmz	è¿¯
jgms	è¦–
jgmv	éœ
jgmy	é’ƒ
jgfm	ç¥Œ
jgfd	ç¥¦
jgfn	ç¥¸
jgfz	é¹
jgfs	ç¦ª
jgfy	é¹
jgdb	ç¦·
jgdf	ç¥
jgdn	ç¥¥
jgdh	é® ç¥¶
jgdj	ç¥‚
jgdq	ç¦š
jgdx	ç¥±
jgdz	ç¦­
jgds	ç¦…
jgdv	ç¦‰
jgdy	ç¦Œ
jgtl	ç¦—
jgtg	ç¦©
jgtw	ç¥¾ ç¦
jgty	ç¥›
jgnp	è°°
jgnf	ç¦‚
jgnk	ç¥µ ç¥»
jgns	ç¥–
jglm	çœ¢ ç›Œ ç¦•
jglf	ç¥  é‹¦
jgln	é¸³
jgll	æ€¨
jglj	å¤—
jglq	é´› é§Œ
jglx	å¦´
jglc	ç¥”
jgls	ç¦„
jglr	ç¦˜
jggb	é‘›
jggf	ç¦ ç¦Ÿ
jggt	ç¦ 
jggq	éŒ‘
jggx	ç¥ˆ
jggc	è° é½
jgkf	è¯Ÿ éŠ—
jgkd	ç¥†
jgkt	ç¦ ç¥¬
jgkq	ç¥´
jgkz	é¾²
jgkc	ç¦£
jgky	ç¦°
jghb	ç¦ ç¦¶
jghf	ç¥‘ ç¥°
jghd	ç¥§
jghz	ç¥
jghr	ç¥¯
jghv	å¤
jgjf	å¤¡ ç¥«
jgjd	å¶
jgjg	å¤š
jgjj	å¤  ç¥ª éƒº
jgjx	ç¥¢ ç¿—
jgjz	è¿»
jgjc	ç¦’ ç¦´
jgjs	ç¥¿
jgjr	ç¦¬
jgjv	é¯
jgqb	é¨
jgqp	æ¡€
jgqm	èˆ›
jgqf	ç¥
jgqd	ç¦¯
jgqg	ç¥“
jgqk	ç¦®
jgqv	é¿†
jgqw	é¾
jgxb	é é‘•
jgxm	é
jgxf	é•
jgxt	ç¦‹
jgxg	ç¥—
jgxj	ç¥‡
jgxx	ç¥¤
jgxz	ç¦«
jgxs	é®
jgxv	ç¥²
jgzf	ç¦§ ç¥®
jgzd	ç¥£
jgzc	ç¦±
jgzv	ç¥š ç¦
jgcb	ç¥º
jgcp	ç¦–
jgcf	ç¥’
jgcd	ç¥³
jgct	ç¦¥
jgcn	ç¦²
jgcq	é£
jgcv	é
jgsm	é
jgsf	é‹¸ ç¥œ
jgsd	ç¦Š
jgsh	ç¥¹
jgsc	ç¥·
jgss	ç¦ƒ
jgsr	ç¦‡
jgrb	ç¦µ
jgrp	ç¥¼
jgrn	ç¦‘
jgrg	é£§
jgrq	ç¥„
jgrx	ç¦¢
jgrz	ç¦”
jgrv	ç¦“
jgvd	ç¥
jgvs	æ–˜
jgwf	ç¦
jgwd	ç¦³
jgws	ç¥½
jgyb	è§µ é„
jgyg	é¿…
jgyq	ç¦¨
jkbh	é¿¹
jkbx	ğ©½¾
jkbs	é²©
jkby	é‘ˆ
jkmp	éŠ è°
jkmk	å
jkmj	é²ƒ
jkmv	é³
jkfb	é‰
jkfp	è§« é‹‰
jkfm	è¯ƒ éˆ³ é¶
jkft	é¢
jkfk	é‹€
jkfj	é³„ é‰• é‚ é‘
jkdm	é³
jkdf	é³
jkdn	é²œ
jkdh	é³’
jkdz	é²¢
jkdc	é³Ÿ é³‰
jkds	è¯„
jkdr	ğ«š•
jkdv	é²•
jktd	é³‚
jktt	é²‘
jktl	é³ƒ
jktw	é²®
jkty	é…
jknf	é²·
jknd	é²—
jknk	é²´
jknj	éˆ
jknq	è¯«
jknw	é¿•
jklf	é³‘
jkln	é²¬
jklg	é‹±
jklc	é²‹
jklr	é³ é¿·
jkly	é²› é²º
jkgm	é³™
jkgf	é²˜
jkgd	éƒ
jkgg	é¿¶
jkgh	é³“
jkgj	è®µ é‰…
jkgc	é³Š é³š
jkgs	ğ©¾Œ
jkgr	éŠ•
jkkp	ğ¬¶ 
jkkm	é²„
jkkd	ğ¬¶Ÿ
jkkt	é²¾
jkkg	é²¡
jkkj	é²€
jkks	é²†
jkkv	é²°
jkky	é² 
jkhp	ç¨£
jkhf	é²‡
jkhd	ğ¬¶
jkht	é¿¸
jkhg	é²ˆ
jkhh	é³… é‘·
jkhj	éŠ¸
jkhx	é²§
jkhs	é³ˆ
jkhr	é²Œ
jkhv	è¯¹ é‹„ é‹· é
jkhw	é³‡ éŒ½
jkjb	èˆ‡ æ­Ÿ
jkjf	ç¤œ
jkjd	é²«
jkjn	èˆ‰ æ“§
jkjg	é‡´
jkjj	ğ¬¶
jkjq	èˆƒ é‰ é¸’
jkjx	ğ¬¶­
jkjz	è½
jkjs	é²µ
jkjv	é²¤
jkjw	è­½
jkqg	é‹ª é±¿ é²…
jkqk	é³¢
jkqq	é²”
jkqc	é›
jkqr	éª
jkxf	é²ª
jkxd	ä²Ÿ
jkxg	è¯• é‰½
jkxx	é³”
jkxc	é²Ÿ
jkxr	é³›
jkzb	è¼¿
jkzf	é²’ ğ¬¶®
jkzl	é¿µ
jkzh	é³
jkzj	éŒ·
jkzx	é©
jkzz	éˆ
jkzv	é²Š é³¤
jkzw	é³†
jkcb	é³œ é²¯
jkcp	é²½
jkcl	éš é³¡
jkck	éŒ
jkcv	é³ 
jkst	é²» é¿
jksk	é‹
jksj	é²“
jkss	é²
jksr	é²¼ ä² 
jksy	é²¿ ğ«š­
jkrb	é²²
jkrp	éŒ¬ éŒ¸
jkrm	é³
jkrl	é²¶ é¸ ğ¬¤
jkrj	é‰”
jkrx	é³
jkrz	é³€
jkrc	é²¥ é„
jkrr	é²³ é‹
jkrv	é³— é‹
jkry	é²™
jkvt	é²£
jkvq	é²­
jkvy	é³‹
jkwk	é³£
jkwj	è¯“
jkwq	é²š
jkwv	é¿´
jkyf	é²
jkyt	éŠ
jkyj	è®´
jkyx	é³•
jkys	é²¹
jkyr	é¯
jhpp	é«
jhpd	é‹“
jhpt	é‹µ
jhpn	è¯± éŠ¹
jhph	é¬
jhpx	è¯¿ éŒ—
jhps	é‘—
jhpr	é‘™
jhmb	é
jhmp	é³
jhml	é´
jhdd	éŠš
jhdt	é‡
jhdl	é­
jhdv	é´
jhtb	é‘½
jhtm	é‘ª
jhtf	è¯° é‹¯
jhtl	é‘¢
jhth	éª
jhts	è¯œ éŠ‘
jhty	éŠ©
jhnb	é
jhnd	é­
jhnl	é“
jhnk	é€
jhnq	é‹¨
jhnw	é«
jhlf	è§¿ é‘´
jhln	è§½
jhlq	é’€
jhlw	é™
jhkf	é·
jhkk	é§
jhkc	é» é‘†
jhhp	é‘…
jhhn	é¬
jhhh	é’
jhqh	éŠµ
jhqc	è°¢
jhzg	é‹Œ
jhcg	éŒŒ
jhsf	è¯ éŠ›
jhsl	æ‡–
jhsk	éŒ˜
jhsj	é¤
jhrp	é‘  è§»
jhrr	éŒ¦
jhrw	é 
jhvg	å‘
jhvz	éš
jhwm	é½
jhyy	é°
jjbv	é¦†
jjpk	é¦‡
jjmj	éŠ«
jjmv	é¦‹ éª ğ«²
jjft	é‘±
jjfn	é¿
jjfc	é‘°
jjfr	é¦ˆ é±
jjfy	èš€
jjdt	é¦
jjdk	é¥¼
jjtm	é¦Œ
jjnd	é¦•
jjnq	éµ®
jjnc	éŒ€
jjnw	è§¼
jjlb	é†
jjlf	é¥²
jjlt	é¦
jjlg	é‰§
jjls	éŒ„
jjlv	é¥§
jjly	é¥º
jjgf	éŠ˜
jjgg	å¤Ÿ é‰¹
jjgq	é¦‰
jjgs	éº
jjgr	é‰¯
jjgw	é¦“
jjkp	ğ«—§
jjkm	é¥¤
jjkk	é¥¾
jjkh	é¥µ
jjkj	é¥¨
jjkc	é¦
jjks	é›
jjhh	ç‡„
jjhq	é¥¿ é¥¦
jjhz	é¥ª
jjjp	é¦€
jjjf	é¥¸
jjjj	é¦…
jjjv	é¦Š
jjqd	è°• é®
jjqr	é‘¥
jjxm	éŒš è¯¤
jjzh	é¥¬
jjzx	é¦
jjzr	é¥°
jjcd	é¦
jjcj	è¯¡ è§¤
jjcv	é¦‘
jjcw	è°µ
jjsn	é¥½
jjsg	é¦”
jjss	é¥±
jjrb	é¦„
jjrp	é¦ƒ
jjrv	é¦’
jjvq	é¥¯
jjwf	é¥¹
jjwd	é¥»
jjwk	ğ«—´
jjyf	é¥´
jjys	é¥¶
jjyw	é¦‚
jqbb	é­®
jqbt	é°˜
jqbg	é°«
jqbk	é°š
jqbx	é®Ÿ é¯®
jqbz	é¯¶
jqbc	é­µ
jqbs	é­« é¯‡
jqbr	é®¨
jqmd	é°‚ é±
jqmn	éŠŒ
jqmh	è®¶ é‡¾
jqmq	é°¢ é±¡ é±¥
jqmr	é±°
jqmv	é°¥ é‹£
jqfp	é±¢
jqfj	é°
jqfs	é±“
jqfv	é¯²
jqdb	æ­ˆ
jqdp	é
jqdm	é±—
jqdf	é±” é®–
jqdt	é±ƒ
jqdn	é®®
jqdl	æ„ˆ
jqdg	é±¶
jqdk	é­¾ é®©
jqdh	é®· é°œ
jqdj	è§ é®¬
jqdq	æ¯¹
jqdx	é®µ
jqdz	é€¾
jqdc	é±’
jqds	è¦¦
jqdr	é±›
jqdv	é„ƒ é® é°Œ
jqdy	é°¦
jqtm	é°ª
jqtd	é°ƒ
jqtt	é®­ é¯¥
jqtl	é°“
jqtz	é¯
jqts	é±™
jqtw	é¯ª
jqty	é­¼
jqnm	é°®
jqnf	é¯›
jqng	é­¥ é¯„
jqnk	é®‚ é¯
jqnq	é· 
jqnx	é±¦
jqlb	é­¤
jqlp	é®´ é°‡
jqlm	é­£ é¯­
jqlf	é°Ÿ é±Š
jqld	é¯¸
jqlt	é°¡ é°·
jqln	é¯’
jqlg	é®˜
jqlq	é®²
jqlx	é¯œ
jqlz	é±†
jqlc	é®’
jqls	é±
jqlr	é°­
jqly	é®« é¯´ é¯¾
jqgb	é±‘
jqgm	é±…
jqgf	é®œ
jqgd	é°¯
jqgg	é­² é¯³
jqgh	é°³
jqgq	é®„
jqgc	é¯¿
jqgs	é±‡
jqgv	é°•
jqkp	é¯Ÿ é¯  é°Š
jqkm	é­º
jqkd	é¯»
jqkt	é°
jqkl	é±º
jqkg	é¯†
jqkk	é­±
jqkh	é¯‹
jqkj	é­¨ é®” é®¿ é°‹ é°¸
jqkz	é°± é±
jqkc	é±„
jqks	é®ƒ
jqkr	é­³ é®§ é°½
jqkv	é¯« é¿
jqky	é¯
jqhp	ç©Œ é±³
jqhm	é±¸
jqhf	é® é¯Œ
jqhd	é®¡ é¯
jqht	é¯± é±• é¿³
jqhn	é¯š
jqhl	é­¸
jqhg	é­
jqhk	é±‹
jqhh	é° é¯“
jqhq	é­ 
jqhx	é¯€ é¯˜
jqhs	é°
jqhr	é®Š é°¤
jqhv	é®
jqhw	é°‰
jqhy	é°¬
jqjb	é±®
jqjp	é®½
jqjf	é®¯
jqjd	é¯½
jqjn	é¹«
jqjg	å°±
jqjj	é® 
jqjq	é±» é·²
jqjx	é°¶
jqjz	è¹µ
jqjc	é¯©
jqjs	é¯¢ é°°
jqjr	é± 
jqjv	é¯‰
jqqg	é­· é®
jqqk	é±§
jqqq	é®ª é°–
jqxm	é±
jqxf	é®¶ é¯ƒ
jqxd	é®£
jqxg	é°
jqxk	é±· é­Ÿ
jqxh	é­¦
jqxx	é°¾ é®™
jqxz	é±
jqxc	é±˜
jqxr	é¯ é°¼
jqxv	é®¼ é¯‚
jqzf	é®š é±š
jqzd	é¯¯
jqzg	é¯…
jqzh	é°©
jqzq	é±µ
jqzx	é®¾
jqzv	é®“ é°€
jqzw	é°’ é±«
jqcb	é±– é¯•
jqcp	é°ˆ
jqcf	é®‰ é°™
jqcn	é±±
jqcl	é±¤
jqcq	é¯ é°„ é°” é±´
jqcv	é­½ é±¯
jqcw	é±¹
jqsb	é±
jqsp	æ§©
jqsf	é®•
jqst	å¡ˆ é¯”
jqsk	æš¨ ğ¬¶¨
jqsj	é®³
jqsq	é®¹ é±€
jqsx	é®›
jqsc	é±‚
jqss	é®‘
jqsr	è°® é• é¯º é°† é±¨
jqsv	é­©
jqsy	é°— é±²
jqrb	é¯¤
jqrm	é°›
jqrn	é°…
jqrl	é¯°
jqrg	é­¿
jqrq	é­ª
jqrx	é°¨
jqrz	é¯·
jqrc	é°£
jqrr	é¯§ é±ª
jqrv	é°» é¯£ é¯¹ é°‘
jqry	é¿©
jqvb	é°¿
jqvg	éˆ¸
jqvq	é¯–
jqvs	é­­
jqvv	é±œ
jqvy	é° 
jqwf	é®¥ é¯¦ é°
jqwt	é­§
jqwn	é¯™
jqwk	é±£
jqwh	é¯
jqwq	é°
jqwv	é®— é±­
jqwy	é­° é®Œ
jqyf	é® é±
jqyt	é°¹ é±©
jqyq	é­¹
jqyx	é±ˆ
jqys	é¯µ é°º
jqyr	é¯‘
jqyv	é±¬
jqyw	é®» é¯¼
jxbv	é‹Ÿ
jxmm	é½
jxmt	é‚
jxms	è¦™
jxfk	é‘©
jxng	éµ
jxlf	è¯­ é‹™
jxlw	é›
jxkj	éˆ£
jxks	æ¯ è§¨ éŠ¾
jxjf	éŠ½
jxjd	é‹¹
jxjg	è¯‹ è§
jxjr	éŒ‰
jxxc	é
jxxs	è°¬ é
jxxw	é‘ƒ
jxrk	è¯¬
jxvx	é¢
jxwg	çº
jxwq	ç…
jzbw	é‘€
jzmb	é‘Ÿ
jzmv	è¯ˆ éˆ¼
jzdj	é‰‡
jzln	é‹¢
jzlg	è¯ é‹‹
jzlc	é‘„
jzlv	è§
jzgv	è°– é°
jzkp	é¼
jzjg	è¯² é‹‚
jzzh	è°£ é
jzrv	è§´
jzrw	é‘
jcbw	è©¹ ç””
jcmq	é‘–
jcfq	é¼ ğ«¯
jcfw	é‘µ
jctm	é‘‰
jcnb	é
jcnd	éˆ
jclb	éŒµ é  
jclj	å± éˆª
jclq	è¯š é‹®
jclr	ğ¬±Ÿ
jclv	é‘Š
jckp	è° é±
jckg	é‹
jckj	é‰ª
jckq	è§¾
jckc	é‘®
jcks	éµ
jckv	è°¨
jchn	è§£
jchz	é‚‚
jchy	èŸ¹
jcjf	é
jcqf	è¯º é©
jczd	çŸ¦
jccp	é·
jccf	é£
jccq	é‘¶
jcsb	éŒ¤
jcsj	è°Œ é–
jcsq	éš
jcsx	é
jcsr	é¯
jcrd	è°Ÿ éŒ
jcvp	è°‹ é’„
jcvd	é‹ 
jcvc	é’
jcwh	è°
jcwj	é‹©
jcwz	é‘
jsbn	é‹
jsbx	é
jsmb	é– é»
jsmd	é¥
jsmx	é
jsfb	é‘œ
jsfp	é¿
jsft	éº éœ
jsfn	é£
jsfq	é’‚
jsfs	è°  é²
jsfr	é›
jsfy	é¸
jsdl	æ†Œ
jsdc	é˜
jsnf	é‹¿
jsnq	è°³ é¶‚
jsny	é‘
jsld	è¯»
jskd	å‰‘
jskj	éˆ±
jsks	è§¥ éŠ§
jskr	é²
jskw	æ•›
jshc	è¯ª é‹³
jshw	è¯³
jsqj	éŠ¬
jsqr	è¯¸ è§° éº
jszh	é‹¾
jscb	é¼
jssg	é‰
jsrp	é
jsvl	éƒ é¯
jrbb	éŒ•
jrmv	è°© é
jrfx	é¤
jrlf	é‹¡
jrll	è°‚ éŒœ
jrlg	éˆ´
jrgs	é é‘¤
jrkc	é€
jrkv	éš
jrhv	éŸ
jrxf	é—
jrxx	é‰
jrsj	è°’ é»
jrss	é¤
jrsv	éŒ«
jrrt	éŠ¼
jrrj	äº€
jrrq	è°¶ é‘¯
jrvs	æ–
jvmg	éŒ»
jvms	éŠ¢
jvnb	é ¯
jvlm	é‡
jvlt	å¢…
jvlk	è±‹
jvlx	ç¥­
jvlw	è©§
jvkm	éŒ’
jvhd	éŒ¶
jvhx	çˆ’
jvqq	ç„¶ é»™
jvzz	é™
jvrv	éŠ
jvvp	éŸ é‘­
jvvk	é¦
jvvr	é§
jvvv	éŒ£
jvvy	é—
jvwz	é‚
jwfd	é‘²
jwdv	é‘‡
jwnf	é¬
jwln	è°† éŒ
jwlw	é“
jwhd	éŠ¥ é„
jwsm	é‹’
jwsz	é 
jwrs	è°‡ éŒŠ
jwyn	é²
jwyh	é‹¶
jwyq	éŒ¥
jwys	éŠƒ
jwyr	è¯¥
jybq	é¼µ
jybz	é¼²
jybc	é¼¢
jybw	é‹‘
jyps	é©
jymb	é¼°
jymq	é‘‚ é¼³
jyff	éˆ
jydf	é¼«
jydh	é¼¸
jydv	é‘
jytt	é¼º
jytc	é¼­
jynw	é
jylf	é¿¼
jygt	é¼¶
jygg	éŒ¢
jykj	é¼´
jyhn	é‰¾
jyhg	é¼®
jyhv	é¼ª
jyqg	é¼¥
jyqr	é¿»
jyqw	é‘
jyxf	é¼¯
jyzm	é‘‘
jyzd	è¯¶ é¼·
jyzs	é‘¬
jycf	é¼¦
jysf	é‘
jysv	é¾
jyrx	é¼¹
jyvb	é‘¦
jyvt	é—
jyvq	é¼±
jywv	é¼¨
jywy	é¼¤
jyyb	é»Œ
jyyp	æ–…
jyyf	åš³ ç¤
jyyt	å£†
jyyn	å­¸
jyyh	å¶¨ ç‡¢
jyyj	è§·
jyyq	é– é±Ÿ é·½
jyys	è¦º æ¾© é’
jyyw	æ–† é›¤
qbbm	é•©
qbbr	é”´
qbgf	ç »
qbgd	è¢­ ä¶®
qbgt	å„
qbgg	é¾š
qbgh	è‹
qbgw	è©Ÿ
qbkc	é•“
qbjx	é•²
qbqb	é•”
qbqy	ğ¬­
qbyx	ğ¬­©
qmtq	ğ¬­¶
qmln	å­˜
qmkd	é•®
qmhf	ğ¬Œ—
qmhn	é¸¦
qmhq	é´‰
qmhz	è¿“
qmhv	é‚ª
qmhw	é›…
qmjg	é”£
qmsy	é•¯
qffj	é”·
qfzd	é•
qfzz	é•Ÿ
qdpm	ğ¬­¸
qdpx	é•‚
qdmg	é’š
qdmc	é”µ
qdfj	é”©
qddx	é•£
qdgh	é”‘
qdkm	é•’ é”œ
qdkn	æ°§
qdkz	ğ¬­¼
qdkr	é•¨
qdky	é•ƒ
qdxc	ğ¨±”
qdsn	é”›
qdsz	é“¾
qdwd	é•
qtyx	é•™
qndk	æ°¤ é“Ÿ
qnsg	ğ¨±‡
qnsk	é”¢
qnsh	é”„
qnrm	æ°³
qnrd	é“¡
qlbf	é•‘
qlbs	é“§
qlnm	é”°
qlnf	é•
qlld	ğ¬­¤
qlgf	ğ«”
qlgk	é•«
qlkf	é”«
qlkl	é•±
qlks	é•œ
qlhd	é“†
qlvs	æ°¯
qlwn	é•Œ
qgfy	é•ª
qgdh	é•°
qgnp	é•§
qgnk	é”
qgnr	é”
qglf	é””
qgqr	é•„
qgxb	é”¨
qgxm	é•›
qgcv	é•€
qgsf	é”¯
qgsr	é”§
qgyb	ğ¨±‘
qkfm	é’¶ é¿”
qkfk	è±Š
qkfh	è±‘
qkfj	è‰¶ é’·
qkfv	é„·
qkdp	é“¼
qkdd	é“—
qknj	é’
qklg	é“½
qklv	é“´
qkgj	é’œ
qkhk	æ°© é“”
qkhv	é•Š
qkjg	ğ¬¬©
qkjq	é’º
qkqg	é“º
qkqc	é•ˆ
qkck	æ°¬
qksk	æ°«
qkrp	æ°­
qkyt	é“š
qhpn	é”ˆ
qhph	é”¹
qhmp	é•
qhdd	é“«
qhdt	ğ«”
qhtf	é”†
qhts	é“£
qhty	é“¥
qhnd	é¿«
qhnq	é”‡
qhkf	é•¤
qhzg	é“¤
qhsf	é“¦
qhsk	é”¤
qhsj	é”¸
qhrr	é”¦
qhrw	é”½
qhyy	é•š
qjmj	é“¯
qjmv	é”¼
qjfb	å°µ
qjft	é•µ
qjfn	é•
qjdh	å°²
qjnp	å°®
qjlg	ğ¬­
qjgf	é“­
qjgq	å°³
qjks	é”»
qjkr	é•¥
qjhg	ä¥½
qjjj	å°¯
qjxm	é“®
qjsg	å°¨
qjrq	å°¬
qjvm	å°´
qjym	å°·
qjyv	å°°
qqmv	é“˜
qqlb	é¾“
qqkq	æˆ«
qqqy	é£™ é£†
qqvg	é’¹
qxbv	é”“
qxng	é”®
qxlf	é“»
qxkj	é’™
qxkq	æ¯»
qxkz	é€
qxxs	é• 
qxvx	é•–
qzff	ğ¬­³
qzgv	é”¾
qcbh	é“¹
qcnb	é•¢
qcnd	é”³
qclq	é“–
qclv	é•¬
qcjf	ğ¨±
qcqf	é”˜
qcsb	ğ«“¹
qcsr	ä¦ƒ
qcrd	é•†
qcvd	è¾²
qcwd	è¢ƒ
qcwj	é““
qsmd	é”²
qsmx	ğ¬­¬
qsft	é•—
qsfs	é•‹
qsnr	é”
qsny	é•´
qshc	é“¸
qsql	é¬µ
qsqj	é“
qsqs	å…“
qsqr	é”— æœ
qsqy	è ¶
qsvl	é”ª
qrbb	é”Ÿ
qrmv	é•˜
qrlg	é“ƒ
qrkc	é”
qrkv	æ°±
qrsv	é”¡
qrrt	é”‰
qvgm	ç›‹
qvkm	é”•
qvkl	æ…¸
qvkz	é°
qvkr	å¸¶
qvxk	æ°¢
qvvt	é“¿
qwfd	é•¶
qwnf	é•
qwln	ğ¬­š
qwlw	é•¦
qwhd	é“± é”¿
qwsm	é”‹
qwyh	é”
qwys	é“³
qwyr	æ°¦
qylw	é›„
qyks	é“™
qyxx	ç¿ƒ
qysv	é”º
xbbr	åª˜
xblm	å¬£
xbkb	å¬ª
xbkk	åª—
xbkz	åªˆ
xbkc	å«
xbht	å¬¸
xbhq	å§¹
xbjj	å©‰
xbjy	åª¿
xbqb	å«”
xbzd	å«‰
xbrl	å«‡
xbvx	å©ƒ
xpnq	é·…
xmbx	å­†
xmtg	å¬•
xmtq	å«¼
xmgq	ç…•
xmkd	å¬›
xmkt	ç•±
xmhv	å¬
xmjd	å¬½
xmqb	è‚ƒ æ­— ç²›
xmqm	è‚…
xmqn	é¹”
xmqq	é·«
xmsz	é€®
xfmb	é ¤ è³¾
xfmq	ç†™
xfmx	åª
xfms	å·¸
xfmr	é¢ èµœ
xffp	å¬ 
xffk	å™©
xffs	å¬‹
xffw	å­
xfnq	é´½
xfkd	å¨±
xfjb	å¨¯
xfjd	å¨›
xfzz	å«™
xfsb	å¬‡
xfyx	çµ®
xdpm	å«¾
xdmf	å¨
xdmg	å¦š
xdfj	å©˜
xddx	å«½
xdnd	åª†
xdns	åª”
xdlg	å¦«
xdlq	åª¯
xdgh	å¨£
xdkm	å©
xdkf	å«¸
xdkd	åªŠ
xdkl	å¬¨
xdkk	å«…
xdkh	å«Œ
xdkz	å¬˜
xdxv	åª¨
xdzw	è¦†
xdsz	é·
xdrs	å©µ
xdvj	å§±
xdwd	åª„
xdwq	å¬Ÿ
xtbw	å©ˆ
xtfd	åª´
xtdg	å©
xttd	åŠƒ
xttn	ç•µ
xttk	ç•«
xtts	å¬ˆ
xtlh	å¨š
xtlx	å«
xtkr	å§µ
xthv	å¬”
xthy	é¢ª
xtrk	æ™
xtyx	å«˜
xndm	è¡‹
xndk	å§»
xntf	å©¤
xnnk	å§—
xnlg	å»º
xngb	å©°
xnsk	å©Ÿ
xnsy	åª¸
xnrm	åª¼
xnvm	åª¢
xnwd	å¬
xlbf	å«
xlbr	åª‚
xlfp	åª¬
xlnf	å«¡
xlnl	æ
xlnv	å¨œ
xlgp	åªƒ
xlgm	å¦¤
xlgn	ã›š
xlgk	å¬
xlkp	åª‡
xlkf	å¾ å©„
xlkl	å¬‘ å¿¢
xlkq	å¬‚
xlkz	å«œ é€œ
xlkv	éƒš
xlkw	æ•”
xlky	ã›¹
xlhd	å¬¢
xlhx	è¾¦
xlhz	å§™
xljd	å¬¼
xljr	å¨°
xlzq	å©¿
xlsm	åª
xlvs	å¨½
xlwq	å«¶
xlwv	å­‡
xlwy	è ½
xgpp	å«²
xgpm	å¬·
xgpf	å­Š
xgpy	å¬¤
xgmq	è¦Š
xgmv	å©½
xgmy	å­
xgdm	è¦‰
xgdd	å«‹
xgdh	å¬š
xgnp	å¨´
xggc	åª¥
xgkf	å§¤
xgkt	åª‰
xgjv	å«
xgxm	å«
xgxs	å«
xgcq	å«¬
xgsf	å©®
xgwy	å¨¹
xgyb	å«¹
xgyq	å¨“
xkby	å¬­
xkmb	è²¢
xkmp	åª¡
xkml	æ…
xkmq	å«£
xkms	æ±
xkfb	å«° å¬¾
xkfp	è¾£ å¨•
xkfm	å¦¸
xkfl	æ
xkfg	é
xkfh	è“
xkfj	å«— éŠ
xkfz	è·«
xkfw	å«©
xkfy	è›©
xkdb	é …
xkds	å©–
xkdr	é¡¹
xktf	å·¬
xktn	å©³
xknl	å­‹
xknr	è´¡
xklf	å·­
xklh	åŠŸ
xkgj	å§–
xkgr	å§¨
xkkj	å·§
xkhp	åª£
xkhk	å¨…
xkhv	å¨µ
xkqq	å¨€
xkxz	å©•
xkzl	å«•
xkcl	å¬º
xkck	å©­
xkcj	å«Ÿ
xksk	å¨™
xkrp	å¨» å©¡
xkrk	å§®
xkrc	å«¥
xkyt	å§ª
xkyj	å¦ª
xhpd	å¨³
xhpx	å©‘
xhmb	åªœ
xhmn	å¬¶
xhml	åª³
xhfb	é µ
xhfd	è£ 
xhfn	ç¾¤ ç¾£
xhfq	ç„„ éµ˜
xhfs	è¦ 
xhfr	å¸¬ ğ«–³
xhfv	éƒ¡
xhdd	å§š
xhdt	å¬
xhdv	åª
xhts	å§º
xhtw	åªº
xhnb	åª²
xhnt	åª¾
xhnq	å¨¥
xhlf	å­ˆ
xhlh	åŠ£
xhgg	å§‚ è¦‚
xhgv	å©¾
xhhp	å¬«
xhhn	å«­
xhjh	å§Š
xhxz	åª«
xhzg	å¨—
xhcg	å©©
xhsf	å§¡
xhsk	å¨·
xhrr	å©‚
xhrw	åª“ å¬“ è¦ˆ
xhww	å¬
xhyq	æ¯Ÿ
xjmb	åª
xjmr	å¬’
xjmv	å«‚
xjfn	åª•
xjfx	å¬†
xjfr	å¬
xjtb	å¬¹
xjnb	å«“
xjnc	å©¨
xjlg	å§†
xjgf	å§³
xjgn	é¸±
xjgg	å§¼
xjgq	é´Ÿ
xjgr	å§’
xjgv	é‚¸
xjkb	å¬©
xjqd	åª®
xjxm	å©™
xjcj	å§½
xqmm	å©£
xqjg	å¨
xqxq	åª 
xqvg	å¦­
xxbz	ç¿¬
xxbc	ç¿‚
xxbs	ç¿š
xxbr	å©¦
xxfm	ç¿€
xxfj	å§¬
xxdb	é ¨
xxtg	ç¿¼
xxtk	å«¿
xxnq	ç¿µ
xxlf	å¨ª
xxld	ç¿­
xxlg	æˆ³
xxlk	ç¿Œ ç¿‹
xxlq	é¸
xxlx	ç¿£
xxlw	ç¿Ÿ
xxkz	ç¿´
xxkc	å°‹
xxkr	ç¿œ
xxkv	å½  é„©
xxhf	ç¿
xxhs	ç¿† ç¿«
xxhr	ç¿’
xxhy	é£
xxjr	å©š
xxqg	ç¿‡
xxxk	ç¾¾
xxxs	å«ª
xxxw	å¬¥
xxsm	å¬§
xxsv	ç¿„ è¦…
xxrb	é¡Ÿ
xxrd	å‰¹
xxrn	é¹¨
xxrg	æˆ®
xxrh	å‹ 
xxrq	é·š
xxrz	ç¿¨
xxrs	ç¿
xxrv	é„
xxrw	é›¡
xxvx	å«–
xxwf	ç¿¯
xxws	ç¿ 
xxyq	æ¯£
xxyw	ç¿ª
xzbk	å¬„
xzbv	å«’
xzbw	å¬¡
xzmb	å¬»
xzmv	å¦°
xzff	å¬‰
xzft	å¬¯
xznq	é·£
xzln	å¨
xzlg	å¨«
xzlc	å¬¦
xzgm	å­‚
xzgv	åª›
xzhq	å¬€
xzhz	å©¬
xzjg	å¨’
xzzh	åª±
xzsq	å«µ
xcfw	å­‰
xctt	å¨¾
xcnd	åª–
xclb	å©²
xclq	å¨
xclv	å¬³
xckp	åªŸ
xckf	å«¨
xckh	åª¶
xckq	å¬¿
xcks	å¬…
xckv	å«¤
xchx	å«„
xcqf	å©¼
xcxq	åª™
xccv	å½Ÿ
xcsb	å¨¸
xcsj	åª…
xcrd	å««
xcvp	åª’ å­
xcvd	å¨ 
xcvc	åª·
xcyv	å¬
xsfx	å«´
xsfr	å«¦
xsfy	åª©
xsdp	å©…
xsdh	å«±
xsng	å©»
xsnh	åª°
xskj	å§„
xsks	å§¯
xsqb	è³®
xsqm	ç›¡
xsqr	åª
xsxv	å©Œ
xsrp	å«€
xsrh	å¬™
xsrr	åª‹
xrbb	å©«
xrmv	å«š
xrlf	å¨¢
xrlg	å§ˆ
xrkv	å©¸
xrrn	é¹€
xrrk	å·«
xrrj	è§‹
xrrq	å­… éµ
xrrs	è¦¡
xvbm	é†“
xvbd	ğ¬ª©
xvbc	é…š é…§
xvbs	é…–
xvbr	é…¯
xvbv	é†¡
xvby	é†œ
xvpp	é†‚
xvmb	å«§
xvmg	å¨¬ é†³
xvmq	é§‘
xvfw	é…² é‡…
xvdm	é…¬
xvdf	ç ®
xvdg	é…
xvdk	é†
xvdj	é†ƒ é…
xvdz	é†š
xvtm	é†˜
xvnm	é† é† 
xvnq	é´‘
xvlf	é†…
xvld	é†¸
xvln	å­¥
xvll	é†·
xvlh	åŠª
xvlq	é†® é†‘
xvls	é† é†— é†±
xvlw	é†€
xvgp	é†¾
xvgf	é†£ é‡„
xvgg	é…¿
xvgx	é†¿
xvgr	é†‹
xvkm	å©€ é…Š é… 
xvkn	é…‘
xvkl	é‡ƒ
xvkg	é…¾ é…º
xvkj	é†§
xvkx	è¾«
xvkc	é…½
xvkr	é†©
xvhp	é…¥
xvhf	é…· é†­ é…Ÿ
xvhd	å©Š
xvhh	é†ˆ
xvhc	é†µ
xvhs	é…° é…”
xvjp	é…´
xvjf	é…©
xvjg	é…¦
xvjr	é†¶
xvjv	é†™
xvqm	é†¢
xvqd	é†²
xvqk	é†´
xvqq	å«· é…­
xvxb	é¡ 
xvxd	å‰½
xvxg	ç“¢
xvxk	ğ«°›
xvxh	å‹¡
xvxx	ç¿² é†¥
xvxz	é†°
xvxs	é†ª å½¯
xvxy	é£„ é£˜
xvzn	é…»
xvzg	é…¶
xvzc	é…¹ é†» é‡‚
xvzv	é…¢
xvcq	é†› é† é†¼
xvcv	é…£
xvsf	é…¤
xvsn	é…µ
xvsh	é†„
xvsr	é†
xvsy	é†
xvrb	é†Œ
xvrm	é†–
xvrz	é†
xvrv	é†’
xvvp	å«» å­„
xvvs	é…™ é…›
xvvv	å¨º é†Š
xvvy	é… å«º
xvwm	é†¯
xvwf	é…ª
xvwd	é‡€
xvwn	é†‡ é†¨
xvwh	é…¼
xvws	é†‰
xvwr	é†•
xvyf	é†½
xvyn	é…—
xvyg	é††
xvyq	é†º é…• é…³
xvyx	å«Š
xvys	é†¦
xvyv	é†¹
xvyw	é…¸
xwbm	å©·
xwfd	å­ƒ
xwhk	å¬—
xwyx	è¾¬
xwyr	å§Ÿ
xypm	å­€
xyff	å¬Œ
xydv	å¬¬
xykj	å¨‰
xyks	å¨†
xyxx	è¾®
xyzd	å¨­
xysr	å¬µ
xysv	åª‘
xyvj	å«®
zbbk	ç®œ
zbbs	ç­š
zbps	æ¦–
zbms	ç‰
zbfk	å£·
zbfs	å—€
zbdp	æ§–
zbds	æ¯‚ ç³“
zbdy	è §
zbtl	æ‚« æ…¤
zbts	æ®¼ æ®»
zbns	é·‡
zblw	æ„› ç¯§
zbgs	å½€
zbkp	çš¼
zbkl	æ‡¿
zbkk	å£¹ å£¸ å£¼ ç®®
zbkj	äº„
zbkq	é·§
zbks	è½‚ è±°
zbht	ç°º
zbhk	å£¶
zbhs	ç©€
zbjm	èˆœ
zbjj	ç®¢
zbjs	è§³
zbqv	çˆ±
zbzz	ç±
zbck	å£º
zbsl	æ„¨
zbsy	èœ
zbvp	ç°†
zbvx	è¾¤
zbvs	ç­¦
zbws	ç‘´
zbys	ç¸ 
zplt	ç±•
zpkj	ç¯
zpcb	ç°¯
zmmb	è³£ ç°¤
zmmp	çš¾
zmms	è¦¿
zmmv	ç±°
zmdm	ç°’
zmdg	ç±‘
zmdj	ç¯¹
zmdx	çº‚
zmdy	ç¯¡
zmnk	å¤
zmkq	ç°š
zmjg	ç®©
zmjc	çˆµ
zmxh	ç¯
zmzm	ç«¹
zmcq	ç¯¾
zmsf	ç£¬ æ¯Š
zmsn	æ’€
zmsh	è² ç½„
zmsj	é§
zmss	æ¼€
zmsr	é¦¨ éŸ¾
zmsw	è¬¦
zmvl	æ€
zmvz	è¿®
zmyw	ç±®
zfbt	è‡º
zfmb	ç¯”
zfmf	ç°¬
zffs	ç°
zffr	ç°®
zfdb	é ¡ é¼™ æ­–
zfdp	æ•¼ çš· é¼”
zfdm	ç½ é¼˜
zfdf	å–œ å˜‰ åš­ å› é¼›
zfdd	é¼š
zfdt	é¼
zfdl	æ†™
zfdk	å™½ å£´ é¼Ÿ
zfdj	å£¾
zfdq	ç†¹
zfdc	å°Œ
zfds	å½­
zfdr	é¢‰
zfdv	é¼“ é¼•
zfdw	ç”
zfdy	èŸš é¼œ
zfnq	é´¶ é¶
zfnr	ç­¼
zflh	åŠ¼
zfkd	ç­½
zfkh	ç®¿
zfxx	ç¿“
zfzb	ç±
zfzf	å–† åš
zfzd	ç°‡
zfzj	ç®·
zfcb	ç°±
zfsb	ç°£
zfsr	ç¯‘
zfrv	ç®Š
zdpx	ç¯“ ç°–
zdmb	é¡› çŸ²
zdmz	ç°
zdfh	èŸ
zdfj	ç®
zdfx	é¼…
zdfr	æ™º
zddx	ç° é•½
zddr	çŸ°
zdnq	é´™
zdnr	é¢ 
zdlw	é›‰
zdgm	çŸ§
zdkp	æ¦˜
zdkd	ç®­
zdkk	çŸ­
zdkj	çŸ©
zdkr	ç­›
zdhx	çŸ®
zdhy	çŸª
zdjz	è¿¤
zdxn	ç®»
zdxc	å£¿
zdzd	ç¯½
zdzx	ç±
zdcv	çŸ±
zdrt	çŸ¬
zdrz	ç¯µ
zdrs	ç®ª
zdvm	ç­•
zdyf	çŸ¯
zdyq	çŸ«
ztfq	ç±–
zttc	ç¯ˆ
ztsd	ç­ 
ztym	ç¯•
znmg	ç±œ
znmj	ç­¢
zndk	ç­ƒ
znts	ç°“
znnk	ç¬§
znlt	ç±€
zngr	ç°
znkk	ç°‚
znkj	ç®
znkx	é¼„
znht	ç°¼
znhk	ç®˜
znjr	ç±¡
znxt	ç±’
zncv	ç®
znsk	ç®‡
znsh	ç­¯
znrb	ç®†
znvn	ç®¨
znvk	ç¬
zlbf	ç¯£
zlmt	ç¯ 
zlmq	ç¯œ
zlms	è¦Ÿ
zlmw	ç­±
zlfm	ç­—
zlnf	å— 
zlng	ç®›
zlnj	ä¹³
zlnv	éƒ›
zlld	ç¯Œ
zlgn	ç­©
zlgk	ç°¦
zlgj	äº‚
zlgx	è¾­
zlgs	è¦¶
zlgv	éƒ”
zlgy	èœ‘
zlkb	ç± 
zlkf	ç¬¥ ç®
zlkg	ç¬©
zlkj	ç¯­
zlkq	é·‘
zlkv	ç¯°
zlky	ç®¯
zlhf	ç¬³
zlhd	ç¬·
zlhz	ç¬¾
zlxq	ç‡¾
zlxx	ç¿¿
zlxc	å£½
zlxy	é­—
zlzv	ç­°
zlcv	ç°…
zlvq	ç¯Ÿ
zlvs	ç®“
zlwb	æ­“
zlwh	å‹§
zlws	è¦³
zlwv	ç¯—
zlyg	ç­
zgmg	ç¬Š
zgmh	ç¬¬
zgfz	ç°»
zgdd	ç¯›
zgdk	ç®³
zgdh	ç°¾
zgnr	ç®€
zglh	ç°•
zggj	ç°„
zggc	ç¯‡
zgkt	ç®¼
zght	ç¯ª
zghg	ç°ˆ
zgxf	ç¯–
zgvq	é¶¢
zgyb	ç°§
zkby	ç±‹ é•¾
zkmq	ç¯¶
zkfb	ç±Ÿ ç°Œ
zkfm	ç¬´
zkfj	ç¬¸ ç¯š ç±„
zkfr	ç±
zkdj	ç­‚
zknp	ç­–
zknd	ç®£
zknl	ç±­
zklj	ç¬µ
zkkj	ç®§ ç¯‹
zkkc	ç°¿
zkht	ç±“
zkhs	ç®²
zkhr	ç®”
zkhv	ç®ƒ
zkjj	ç­ª
zkqm	ç° 
zkxz	ç®‘
zkzb	ç°
zkzf	ç°µ
zkzj	ç¯„
zkcp	ç°—
zkcz	ç¯´
zkrp	ç®‚
zkrt	ç¯
zkrc	ç¯¿
zkrr	ç­´
zkrv	ç°œ
zkry	ç­»
zkwj	ç­ ç­º
zkyf	ç®ˆ
zkyd	ç®Œ
zhpd	ç­£
zhpg	ç°ƒ
zhph	ç¯
zhmz	ç±©
zhdd	ç­„
zhdk	ç¼¾
zhdc	ç½‡
zhdv	ç¯…
zhtb	ç±«
zhtm	ç±š
zhtf	ç­¶
zhtz	ç°‰
zhts	ç­…
zhnb	ç¯¦
zhnt	ç¯
zhnh	ç½
zhlm	çˆ³
zhlf	å™•
zhld	ç¼º
zhlq	çˆ²
zhlv	é„¬
zhgf	ç¼¿
zhkz	ç±§
zhhb	ç°´
zhhm	ç½
zhhd	ç½€
zhhn	ç½…
zhhh	ç°©
zhjb	ç½†
zhjh	ç¬«
zhxk	ç¼¸
zhxz	ç½ˆ
zhzg	ç­³
zhcw	ç½
zhsb	ç°°
zhsf	ç­ˆ
zhsn	ç½‰
zhsk	ç® 
zhrs	ç¯¼
zhrw	ç¯
zhry	ç½
zhvr	ç¯©
zjfb	ç±² ç±¨
zjfd	åŠ„ ç®š
zjfc	ç±¥
zjfr	ç°½
zjfw	ç±¢
zjdy	è 
zjll	æ…œ
zjlg	æ¯
zjlk	é³˜
zjlh	æ¯“ å‹„
zjlq	æ¯ é°µ
zjlx	ç¹ ç·
zjlc	ç¯†
zjls	æ¯ ç€ª ç±™
zjlw	æ•
zjgs	ç°¶
zjgr	ç¬–
zjkb	ç±…
zjxm	ç­
zjcw	ç°·
zjsk	ç­¾
zjyg	ç±›
zjyv	ç±¦
zqbg	ç¬¼
zqmh	ç¬Œ
zqsr	ç°ª
zqvq	ç¯¯
zxbr	ç®’
zxmb	ç®« ç°˜
zxmm	ç°«
zxtw	ç±ˆ
zxnq	éµ
zxkb	ç¯¢
zxkp	ç¯‰
zxkf	ç­‘
zxkd	ç¬»
zxkn	ç¯«
zxkr	ğ¬•‚
zxkv	ç­‡
zxhm	ç®µ
zxxw	ç±Š
zxrf	ç°­
zxrk	ç­®
zxrz	é¾
zxvx	ç¯»
zzmv	ç¬®
zzft	ç±‰
zzln	ç­Ÿ
zzlg	ç­µ
zzlc	ç±Œ
zzhn	é¹
zzhq	é·‚
zzhx	ç¹‡
zzhz	é¥
zzhy	é¢» é£–
zzxm	ç®
zcbb	è±¼ è²
zcmv	è²œ
zcfq	ç®´
zcfs	è²š
zcdb	é ±
zcdm	è²–
zcdk	è±¾
zcdr	è²Š
zcdy	è «
zclp	è²…
zclq	ç­¬
zclv	ç±†
zcgt	å¢¾
zcgl	æ‡‡
zcgv	è²‘
zckk	è²†
zckj	ä™ ç¬¹ è²™
zchb	è²”
zcht	è™¢
zchz	é‚ˆ
zchs	è²Œ
zchr	è²ƒ
zchv	è²’
zchy	è²ˆ
zcjd	è²
zcjs	è²
zcjv	è²
zcqf	ç®¬
zcxn	è²„
zczd	è²•
zccf	è²‚
zccd	è²˜
zcct	è²“
zccw	è²›
zcsb	ç®•
zcsp	ç°¸
zcst	ç°Š
zcsx	ç°›
zcrg	è²‹
zcrx	è²—
zcvb	ç¯
zcwf	è²‰
zsbb	é¬¢ é¬“
zsbm	é¬¡
zsbx	é¬ƒ
zsbs	é«§
zspr	ç±
zspy	é¬†
zsmb	é«­
zsmd	é¬Ÿ
zsmx	ç¯²
zsft	ç°¹
zsfy	ç®¶
zsdd	é¬‹
zsdk	é«¬
zsdh	é¬€ é¬‘
zsdj	é¬ˆ é«¢
zsdr	é¬™
zsdv	é«µ
zsnt	é«¯
zsnh	ç¯˜
zsnv	é«¥
zsny	é¬›
zslp	é«¹
zsld	ç­·
zslc	é«³
zslr	é¬
zsgq	é«´
zskp	æ©†
zskm	èˆ
zskd	é¬
zskh	é«¶ é«¿
zskj	ç¬¢
zskq	ç„¡ é·¡
zskc	ç°™
zsks	é«¡
zskv	é„¦
zskw	ç”’
zshf	é«º
zshd	é¬
zshh	é¬
zshc	ç­¹
zsjm	é¬‡
zsjr	é¬ 
zsqb	é¬‚
zsqd	ç®¾ é¬
zsqg	é«®
zsqq	é¬Œ
zsqr	ç®¸
zsqv	é«ª
zsxf	å•
zsxl	é«©
zszf	é«»
zszg	ç°³
zscf	é««
zscd	é¬•
zscg	é¬—
zscj	é«°
zssb	é¬š
zssg	ç°¨
zssq	é«¾
zsss	é«±
zssr	é¬Š
zssy	é¬ é¬£
zsrt	é«½
zsrn	ç®°
zsrr	ç®º
zsrv	é¬„ é¬˜
zsvs	é«¨
zsvr	é¬
zsvy	é¬œ
zswm	é«¼
zswd	é¬¤
zswz	é¬”
zsyq	é«¦
zsys	é¬–
zsyw	é¬‰
zsyy	é¬…
zrbb	ç®Ÿ
zrfx	ç°
zrfw	ç±”
zrdd	è£½
zrdn	æ£
zrlf	ç­¨
zrlg	ç¬­
zrgs	ç¯³
zrhv	ç¯‚
zrjr	ç±‚
zrxf	ç¯¬
zrrq	ç±¤
zvmb	ç°€
zvnr	ç®¦
zvjp	ç¯¨
zvxb	æ¬¾
zvxs	éš·
zvzm	ç¯®
zvvp	ç±£
zvvr	ç°¡
zvvy	ç°¢
zwbc	ç±‡
zwnf	ç¯™
zwkd	ç°”
zwsz	ç¯·
zwrd	ç°‘
zwrs	ç®¤
zwyf	ç± ç±¯
zwyn	ç¯±
zwyw	ç±¬
zyff	ç°¥
zydg	è°¿
zydq	é·„
zydx	ç±˜
zyds	ç±
zydv	ç®™
zydw	é›
zylh	ç­‹
zylw	ç±— ç±±
zygg	ç®‹
zyxj	ä¹¿
zyzm	ç±ƒ
zyss	ç®¹
zysv	ç®½
zyyx	ç±ª
zyys	ç¯¸
cbbg	è—­
cbbh	ä“– è”¤
cbbq	è‘–
cbbs	èœ
cbbr	è’ˆ
cbby	è—Œ è—±
cbms	è¥
cbff	è¥
cbfy	è¤
cbdf	èª
cbdx	è—”
cbds	è¤
cbns	è“
cblm	è–´
cbln	èŒ¡
cblh	åŠ³
cbls	èŒ•
cblr	è“¿
cblw	è’®
cbkb	è”© è–²
cbkm	è‹§
cbkn	è¢
cbkk	è±
cbkz	è‘·
cbhb	è˜”
cbhn	è¦ è—†
cbjj	è€
cbjq	è—›
cbjy	è’
cbxv	è’
cbzd	è’º
cbzh	ä“¨
cbzz	è–¿
cbcp	æ£»
cbcm	è‘
cbsl	è—¼
cbrl	è“‚
cbvb	è˜
cbvp	è”»
cbvn	é¹²
cbvq	æ°‹ é¸
cbvx	è—
cbvc	è’™ è’„
cbvs	è
cbvw	è”²
cbwg	è¹
cbwx	è™Œ
cbyx	è¦ è“Š
cpbs	è™
cpby	è˜
cppm	æ­´
cppr	æš¦
cppv	å¯
cptt	è“•
cplq	è—®
cpgx	è¥
cpgz	è’
cpkj	è—²
cmbb	è–¨ é¡­
cmbm	ç¢
cmbd	å  è´
cmbg	å¤¢ è–
cmbx	è˜¡
cmbv	è˜‰ é„¸
cmbw	ç”
cmmb	è˜‹ è•’
cmmp	è˜ƒ
cmmm	è•‹
cmmh	è¹
cmmr	ğ¬Ÿ
cmdp	è”
cmdx	ç¹¤
cmld	è—ˆ
cmlh	è‘‚
cmjl	è–¡ é¼’
cmjg	è
cmcd	è˜®
cmcq	è”‘ è–‰
cmsg	èˆ
cmsk	è˜´
cmsr	è–¯
cmsy	è–¥
cmvb	è‹
cmwd	è—…
cmyb	è—£
cmyw	è˜¿
cfmb	è’·
cfmf	è•—
cffb	æ­¡ é¡´
cfff	è™ˆ
cffn	é¹³
cffh	å‹¸
cffj	è¼ è•š
cffq	é¸›
cffx	è˜„
cffs	è§€ è•‡
cffr	é¢§
cffv	é„¿ é…„
cffw	é›š
cffy	é£Œ
cflh	åŠ­
cflw	è“¶
cfgx	å›
cfkd	èŒ£
cfkh	è‘º
cfkq	è•º
cfqb	é¡‘
cfql	æ„Ÿ
cfqj	è§±
cfzd	è”Ÿ
cfzj	è‘¹
cfzz	è”™
cfsb	è•¢
cfsr	è’‰
cfrl	è¶
cfrv	è¸
cfvx	ç¶¤
cfyv	è™„
cdbb	è–‹
cdbt	å¡Ÿ
cdbn	è‘¬
cdpb	è˜±
cdpx	è’Œ
cdpz	è’¾
cdpw	è–® ç³¶
cdmb	é † é¿“
cdmg	èŠ£
cdmk	è‹¤
cdmz	è“° è˜
cdmc	è’‹
cdmw	å¦ è™
cdff	è—
cdfk	è–¤
cdfj	è¤
cdtz	è“—
cdtw	è“¤
cdnr	é¡º é¿’
cdnv	è‹
cdlg	ğ«‡­
cdlq	è’
cdgm	è‘¢
cdkm	ä“« è‘•
cdkd	è‘¥
cdkk	è’«
cdkh	è’¹
cdhw	è–‡ è—¢
cdjp	è’£
cdjm	è˜…
cdxn	è‘
cdzd	è“¹
cdzx	è˜Œ
cdzw	è•§
cdsn	è¾
cdsz	è²
cdrg	è–
cdrj	è´
cdrx	è•²
cdrz	è“¯
cdrv	è–š
cdrw	è˜·
cdvm	è‡
cdvj	è‚
cdvx	è˜
cdwq	è“”
cdwx	è‘
ctbq	çˆ‡
ctbw	è± è“º
ctby	è—
ctfz	è–³
ctdz	è–˜
ctdv	è•”
ctdw	è“»
cttp	è˜½
cttt	è—Ÿ è˜²
cttx	è™†
cttc	è‘‘
ctts	è•˜
ctnq	é¶“
ctlh	è®
ctkd	è‘¨
cthy	è‘»
ctsd	èº
ctwd	è˜¾
ctym	è“‹
ctyx	è”‚
cnbp	æ©œ
cnbd	åŠ‚
cnbl	æ† 
cnbk	è”
cnbq	é·¢
cnbz	è¹·
cnby	èŸ¨
cnmg	è˜€
cnmy	ç¹­
cnfb	è»
cndl	è’½
cndk	èŒµ è”¨
cndj	èµ
cndq	é¶§
cndw	é¿¦
cntk	è–—
cnlk	èˆ
cnlw	è“·
cnkg	è’±
cnkk	è”®
cnkz	è“µ
cnhf	è‘€
cnhk	èŒ
cnqg	è
cnxh	è
cncf	è”
cnsg	è
cnsh	è‡
cnss	è¢
cnrb	è
cnrm	è’•
cnrd	å• è
cnrk	è‹¬
cnvm	èº è¾
cnvn	èš
clbb	è’Š
clbf	è’¡
clbr	è’‚
clmt	è“§
clmn	è¡
clmh	è”¬
clmq	è’¸ è“¨
clms	è“š
clmw	èœ
clfp	è‘†
clfm	èŒ½
clfd	è”‰ è—µ
cldp	è˜ª
cltt	é¾¿
clnb	è´—
clnf	è” è”
clng	è°
clnj	èŠ¤
clnq	è™‰ é´ˆ
clnx	è“€ èª
clnz	è—¡
clnv	ğ¦°¡
cllb	è´‹
cllp	è˜‚
cllf	è““
clld	è‘”
clll	è•Š
cllk	è…
cllr	èµ
cllw	é›
clgb	è•·
clgp	è‘‡
clgm	èŠ§
clgd	è‘µ
clgh	è“©
clgq	é¶œ
clgz	è“ª
clgc	èŒ…
clgs	è•Ÿ
clgr	è“£
clkb	è˜¢ é¾
clkm	è·
clkf	è©
clkl	è–
clkj	è’Ÿ
clkq	è–¦
clkx	è–ª è¨
clkz	è”
clks	è—™ è—½
clkr	è»
clkv	è”€ è•«
clhf	èŒ„
clhd	èŒ†
clhh	è”
clhz	è
clhv	è‹
cljb	é ‹
cljd	è—°
cljr	é¡¾
clqm	ç››
clqv	éƒ•
clxv	è‘ 
clzv	è‹
clsm	è‘¦
clvd	è¬
clvq	è’¨
clvs	è‰
clwd	åŠ
clwj	èˆŠ
clwq	è•‰
clwv	è’¦
clyd	è“˜
clyg	èŒ·
clys	è’
clyw	è‘°
cgpp	è”´
cgpf	è˜‘ è˜¼
cgpn	è—¦
cgmh	è‹
cgmz	è•¸
cgmv	è‘­
cgfz	è––
cgfy	è”ƒ
cgdd	è’»
cgdh	è–•
cgdj	è“­
cgnf	ğ¬œ¬
cgnw	è”º
cglg	èŠ
cggj	è”°
cggq	èº
cggx	é¾©
cggc	è¹
cggv	è©
cgkf	èŒ©
cgkh	è‘
cgjv	è“ˆ
cgjy	è“¢
cgxf	è“
cgxg	è§
cgxz	è¦
cgxs	è’‘
cgxr	è®
cgcq	è”—
cgcr	è“†
cgcw	è™‡
cgsp	è˜œ
cgrt	è“™
cgvl	è—¯
cgvc	è”š
cgyt	è˜£ è˜³
cgyq	è±
ckbs	è
ckby	è–¾
ckpx	è”¢
ckmp	è°
ckmq	è”«
ckfb	è”Œ æ­ æ­ è—¾
ckfp	è—»
ckfm	è‹›
ckff	å›
ckft	è‘
ckfl	æ‡ƒ æˆ
ckfg	è‰±
ckfk	è³
ckfh	å‹¤
ckfj	è§ è“²
ckfq	ç‡• é·°
ckfx	å¬Š æ–³
ckfz	è——
ckfc	å¨
ckfs	è¦²
ckfr	è‡¡
ckfv	å ‡ é„ è« é…€
ckfw	é›£
ckdp	è±
ckdd	èš
ckdk	è“±
ckds	è‹¹ è¾
cktk	è–‘
cktw	è”†
cknp	èŒ¦ è•€
cknm	è–€
cknd	è¿
cknj	èŠš
ckns	è¹
cknr	é¢Ÿ è… ğ¬œ¯
cknw	è“›
cklk	è’
cklj	èŒƒ
cklv	è¡
ckgd	è’
ckgg	è’—
ckgj	è‹£
ckgq	é·¨
ckgs	è¯
ckgr	è‘
ckkb	é»ƒ
ckkp	è•–
ckkm	è
ckkg	è’²
ckkj	èƒ
ckkc	è–„
ckks	è
ckhp	è’…
ckhf	è¿
ckht	è—©
ckhq	è˜µ
ckhc	è—‚
ckhr	è¡
ckhv	è†
ckjb	è²°
ckjp	æ¼ è’¤
ckjd	è•
ckjg	èŠ…
ckjh	åŠ± å‹š å‹©
ckjz	è¿£
ckjr	è´³
ckqg	è†
ckqq	èŒ™
ckqc	è’ª
ckqr	è“¸
ckxn	è‘
ckxk	èŒ³
ckxh	è
ckxx	è‹ è–¸
ckxz	è è—«
ckxv	è“¡ è–“
ckzg	è“’
ckzx	è”ª è˜™ è˜»
ckzz	è“®
ckzv	é¿€
ckcf	è¬
ckcz	è“«
ckcr	è—¸
ckcv	è•¤
cksp	è–»
ckst	è‘˜
cksk	è–
cksh	è‘
cksj	è‹‰
ckss	è¢
cksv	è”‹
ckrb	é¡¢
ckrp	èŠ è„
ckrm	è•° è˜¯
ckrn	è•… è•
ckrl	è•™
ckrk	è
ckrq	è™ƒ
ckrc	è“´
ckrr	è¢
ckrv	è•©
ckry	è„
ckvq	è”³
ckwf	è½ è–ƒ
ckwh	è“…
ckwj	èŒ«
ckym	è˜«
ckyf	è­
ckyd	è¿
ckyt	å” è
chpb	è–­ è˜ˆ
chpp	å¤ è”¾
chpm	æ­·
chpf	ç£¿ è‚
chpd	è‰
chpn	è 
chph	è è© è•›
chpj	è—’ è˜’
chpq	è•± è˜“
chpx	è
chpc	è—Š
chps	è—œ èª è’©
chpr	æ›† è«
chpw	èŸ è–
chpy	è˜¶
chml	è’ 
chfn	è­
chfg	èµ
chdb	è– 
chdt	è•ƒ
chdn	è‹¸
chtm	è˜†
chtl	è—˜
chnb	è“–
chnd	è–
chnl	è”¥
chnk	è“¾
chnq	èª
chns	è”–
chkz	è˜§
chkc	è–±
chhh	è—€
chjp	è–’
chzg	è›
chzv	è•¿
chsk	åœ è™
chrb	é¡˜
chrp	è—¥ è–¬
chrl	æ„¿
chrg	è”Š
chrj	è‘©
chrq	è˜¤
chrx	åŸ åµ
chrs	è”¸ å¡ è‚ è‘²
chrr	è— 
chrw	è‘Ÿ è–‚
chvp	è˜– ç³µ
chvn	å­½
chvx	è–›
chvz	èº 
chvr	è’’ è˜¬
chys	è’°
cjpq	é·‹
cjmb	è¯
cjmr	è–ˆ
cjmv	è“ƒ
cjfb	è˜
cjfd	å‰³
cjfn	è‘Š
cjfc	è˜¥
cjfr	å± è–Ÿ
cjfw	è˜
cjdq	è‡§
cjtc	è™‹
cjnc	è•
cjnw	è—‘
cjlg	è‹º
cjlc	è’ƒ
cjgm	èˆ
cjgf	èŒ—
cjgl	è‘¾
cjgg	èŒ¤ è•µ
cjgj	è‹‘
cjgr	è‹¡
cjgv	èŒ’
cjkb	è—‡
cjkd	è“Ÿ
cjkn	è—“
cjks	è‘®
cjqp	è˜‡
cjqd	è® è–Š
cjqn	è˜š
cjqs	å© è”‡
cjcn	è–¢
cjcw	è–
cjsk	è¶
cjsq	è•®
cjsw	è”¹
cjrj	è”¼
cjvx	è”¡
cjvs	è”›
cjwp	æª 
cjwn	æ“
cjwl	æ†¼
cjwq	é©š
cjww	è­¦
cjwy	èŸ¼
cqbg	èŒ å
cqby	é­‡
cqmt	èŒ¬
cqmn	è
cqmh	èŠ½ åŠ
cqmq	é»¡
cqmw	è•¥
cqfl	æƒ¹
cqfz	é€½
cqfv	é„€
cqfy	è š
cqds	é¥
cqjg	å–
cqcd	è•½
cqrg	é¤
cqvg	èŒ‡
cqvr	è”•
cxbr	è·
cxmb	è§
cxmm	è•­
cxfn	è’˜
cxfk	è˜
cxfj	èŒ
cxfx	è• 
cxtw	è–½
cxkf	èŒ¿
cxkx	è’†
cxhf	è™
cxhq	è”’
cxjd	è‡
cxjg	å èŒ‹
cxxx	è‘Œ
cxxc	è•
cxxs	è“¼
cxxw	è—‹
cxcc	è–…
cxsm	è—
cxsf	è‡
cxrk	è
cxvj	è“œ
cxvq	è˜¸
cxvx	è”ˆ
czbm	è•£
czbw	è–†
czmb	è—š
czmv	å è‹²
czft	è–¹
czfv	è–£
czdw	è–™
czln	è©
czlg	èš
czlj	è–
czlc	è–µ
czgv	è²
czhd	è’›
czhq	è”¿
czjg	è“
czjx	è˜©
czxn	è•¼
czzx	è˜¨
czcs	è—
czcv	è–¶
czsq	è•ª
czyd	è’µ
ccmq	è•†
ccfq	è‘´
ccnb	è•¨
ccnq	è’‡
cclh	è‹ˆ
cclj	è‹Š
cclq	è¿
ccgq	è—
cckp	è‘‰
cckv	åª è“³
cchm	è—¶
cchq	è’§
cchx	è’
ccjq	è—
ccxq	è‘³
cccq	è„‹
cccc	èŒ˜
ccsb	è
ccsj	è‘š
ccsq	è˜›
ccsx	å® è—„
ccrn	å²
ccrh	å‹µ
ccvd	è€
ccvc	è“
ccyq	è”µ
csbb	æ¬º æ­
csbp	æ£Š
csbf	ç¢
csbd	å‰˜
csbt	åŸº
csbn	è¸
csbl	æƒ
csbg	æˆ¡ å¤¦
csbh	å‹˜ å°  è‘§
csbj	ç”š
csbq	æœ
csbx	æ–¯ ç¶¦
csbs	æ–Ÿ å™
csbw	è«…
csby	æœŸ èœ èŸ´
cspn	è—•
cspr	è—‰
csmd	è‘œ
csmx	è”§
csfy	è‘«
csdb	è•¦
csdp	èŠ
csdh	è”· è˜ 
csdz	èŠ
csdc	è”£
csng	è³
csnh	è’­
csnw	å°
cskt	è””
cskg	è‘¡
cskj	è‹ 
csks	èŒª
csht	è¥
cshg	è¸
cshh	è»
cshq	è·
cshr	è•
cshv	è••
csqd	è·
csqr	è‘—
csxb	é¡£
csxl	æ…¼
csxq	æˆš
csxz	è¹™
csxv	è½
cszh	è„
cscb	è•¡
csrp	è“
csrn	è¶
csrh	è–”
csrr	è¶
csvl	è‘±
csvg	èŒ
cswd	è˜¹
crbb	è
crmv	è”“
crfx	è”
crfw	è—ª
crdm	è“¦
crdt	å¢“
crdn	æ‘¹
crdh	å‹Ÿ
crdq	é©€
crds	æ…•
crdr	å¹• æš®
crdv	é„š
crdw	è¬©
crdy	èŸ‡
crtc	è’”
crnh	å‹±
crnz	é‚ èº‰
crny	è †
crlf	èŸ
crln	åš
crll	è
crlg	è‹“
crlj	è‹
crgs	è“½
crkv	è•
crhf	èœ
crqp	æª¿
crqt	å£“
crqn	æ“ª
crql	æ‡•
crqg	é¥œ
crqj	å´
crqq	å­ é»¶
crqx	å¬®
crqs	é¨
crqy	é­˜
crxf	è’¼
crzv	è‘ƒ
crsj	è‘›
crrt	è
crrz	é³
crrs	è‘…
crrr	è•Œ
crrw	è“Œ
crvy	èŸ
crwf	å¬
cvmb	è”¶
cvfb	è—¬
cvlc	è¨
cvlv	è–©
cvkp	è”¯
cvkm	è•´
cvkk	è­
cvkj	è¼
cvkc	è®
cvks	è¯
cvhf	ç”›
cvhv	è–Œ
cvjp	è’¢
cvjf	å”‡
cvjd	è¾°
cvjq	è„£
cvjc	è¾±
cvjv	é„
cvjw	æ•
cvjy	èœƒ
cvxp	è˜—
cvxk	èŒ
cvxx	è’œ
cvzm	è“
cvzl	è˜Ÿ
cvry	è”­
cvvp	è˜­
cvvf	è”„
cvvl	è•„
cvvx	è”…
cvvr	è•³
cvvw	è—º
cvvy	è•‘
cvwv	è•¯
cwbb	è–§
cwbm	è‘¶
cwfd	è˜˜
cwdk	è™€
cwdv	è–º
cwnb	è—ƒ
cwnp	è— è—³
cwnf	è’¿
cwjl	è£
cwjh	è’
cwzv	è˜
cwsm	è‘
cwsz	è“¬
cwsr	è—·
cwrd	è“‘
cwrj	è—¹
cwrs	èƒ
cwvw	è•¹
cwyp	è™Š
cwyt	è“„
cwyn	è“ 
cwyq	è 
cwys	èŒº
cwyr	è„
cwyv	è•
cwyw	è˜º
cybw	è¾
cyps	è”±
cymh	è˜
cymj	è‰
cymq	è–°
cyfp	è‘ˆ
cyff	è• è˜¦ è™‚
cydh	è•‚
cydq	è™…
cyds	è—¤
cydv	è” è–·
cynq	é´±
cynw	è‘¼
cylh	è‹­ è•
cylw	è—¿
cygg	èš
cyks	è›
cyqr	èƒ
cyzm	è—
cyzv	è‘„
cysm	è˜Š è—´
cysn	è’³
cysk	è‘’
cysj	è’“ è•
cysq	è–«
cysx	è•¬
cysz	è˜•
cysc	è‘¤ è’¶
cyss	è‘¯
cysv	è‘£ è”  è—§ è˜°
cyrg	è•¶
cyvb	è—–
cyvy	è•“
cyyd	è’¯
cyyn	å­¶
cyyj	è˜
cyys	è”˜
sbbt	æ‚‚
sbbk	æ‚¾
sbmb	æ„¼
sbds	æ½
sbtz	ç–
sblm	æ‡§
sbln	å­› é¹
sbll	æ„‚
sblh	å‹ƒ
sblq	éµ“
sblv	éƒ£
sbkk	æ„ƒ
sbkz	æƒ²
sbjj	æƒ‹
sbjy	æ„§
sbzd	æ„±
sbzz	æ‡
sbrl	æ…
sbvx	æ‚°
sbwf	æ„˜
sbyx	ç´¢ æ…ƒ
sbys	æ±
sppz	æ†·
spmj	è€™
spdb	é ›
spdx	è€§
spdw	è€°
spnh	è€¡
spns	è€
splf	è€ª è€
spln	è€”
spgf	è€±
spgr	è€¤
spkm	è€“
spkj	è€Ÿ
spht	è€©
sphh	è€®
spjf	è€ 
spjc	è€£
spxh	è€–
spch	è€¢
spcc	è€¨
spcv	è€¯
spsf	è€¥
sprn	è€¦
sprx	è€¬
spvb	è€«
spvq	è€•
spvy	è€˜
spwd	è€²
spyf	è€›
spyq	è€— è€­
smbb	é ¿
smbd	æƒ»
smmv	æˆ„
smmw	æ‡¼
smdf	ç ‰
smdd	å‰¨
smtg	æ‡Œ
smkd	æ‡
smjl	æ‚³
smjj	è‰³
smcp	æ ”
smcf	ä‚®
smcd	å¥‘
smcn	æŒˆ é½§
smcl	æ
smcj	è§¢
smcx	ã›ƒ çµœ
smcs	æ´¯
smcy	è›ª
smsl	æ…§
smsh	ç†­
smsx	å½—
smvg	æ‡»
sfbr	å˜—
sfmb	è³ æ„ª
sfmj	é‚• æ‚’
sfmq	é»¨
sfmw	é›
sffb	è³·
sffp	æ‡†
sffd	å–ª
sffj	æ„•
sffs	æ†š
sftd	åŠ
sftv	ä£˜
sfnq	é´£
sfnr	èµ
sfgv	å˜
sfkd	æ‚®
sfjd	æ‚
sfqh	ç‰š
sfcv	ç”
sfsb	æ†’
sfsr	æ„¦
sfwd	è£³
sfyn	é¹•
sfyq	é¶˜ é¶¦
sdpm	æ†
sdpq	éµ´
sdmb	é ˆ é ¾
sdmm	ç›¨
sdmg	æ€€
sdmk	æ€Œ
sdmx	å¬ƒ
sdms	æ¾ƒ
sdmr	æ†
sdfm	æ…»
sdfj	æƒ“
sddn	ç‰‚
sddq	ç…­
sddx	æ†­
sdnd	æ„
sdnx	åª­
sdns	æ„
sdnr	é¡»
sdnw	æ‡®
sdgm	ç‰…
sdgh	æ‚Œ
sdgx	æ–¨
sdkm	ç‰
sdkd	ä¸§
sdkg	æ‡©
sdkh	å•¬ æ…Š
sdjp	æ§³
sdjd	å¥¬
sdjt	å¢
sdjq	ç
sdjc	å°‡
sdjs	æ¼¿
sdjv	é†¬
sdjy	è¿
sdzd	è£ å¥˜
sdzn	å¼‰
sdzh	ç„‹
sdzj	éŠº
sdzx	å¨¤
sdcp	ç‰ƒ
sdsh	ç‰†
sdsx	æƒ­
sdrf	ç‰„
sdrj	åŒ
sdrs	æƒ®
sdvj	æ—
sdyg	æˆ•
stbw	ã¥„
stfq	æ‡´
stdg	æ‚»
stts	æ†¢
stnq	é¶…
stkd	æ„„
stkq	ç£
stkz	ç–€
sthh	æ‡—
snpk	æ‚ƒ
snfq	æ°…
snfr	å¹¤
snfw	æ•
sndg	å—
sndj	æƒ˜
sndq	çŒ®
sndz	é–
sntf	æƒ†
snkk	æ…–
snkx	æ†´
snhp	çšº
snhh	èŠ»
snhq	é¶µ
snhv	é„’
snhw	é››
snsb	æƒ§ å—­
snsl	æƒª
snsk	æ€¬
snss	çŸ—
snrm	æ…
snrd	æ»
snyz	é‚‹
snyy	å·¤
slnw	æ•©
slgm	å¿¬
slgf	æ†°
slgn	æ‚€
slgk	æ†•
slgh	æ„‘
slkl	æ†¶
slkz	æ…
slkr	æ„”
slkv	æ†§
slhh	å” æŠ
slhq	æ„¶
slhv	å
sljd	æ‡°
slsm	æ„‡
slvd	å–
slvj	è§Œ
slwn	æ‡
slwq	æ†”
slwv	æ„¯
sgpm	æ‡¡
sgpf	æˆ‚
sgdd	æ„µ
sgny	æ‚¯
sgls	æ€º
sggb	æ‡­
sggq	æ‚·
sggc	æƒ¼
sghf	æƒ¦
sgxb	æƒ æ‡«
sgxm	æ…µ
sgxs	æ…·
sgwy	æƒ¤
sgyb	é»‰
skbn	ä¸¾ æŒ™
skbw	èª‰
skmp	æœ„
skfb	æ‡¶
skfp	æ‚š
skft	åŒ æ„Š
skfj	æ…ª
skfq	æƒ
skfr	æ‡’
skds	æ€¦ åŒ‰ æ‚¿
sknj	å¿³
sknq	æ‚ˆ
skgj	æ€‡
skgr	æ
skkj	æ„œ æƒ¬
skhh	æ‡¾
skhv	æ…‘
skjp	æ•¯
skjm	ç¯
skjd	åˆ¡
skjl	æ„
skjq	æ€´ é´–
skjr	æ˜¬ æš‹
skjw	æ•ƒ
skjy	èŸ
skqg	åŒ æ‚‘
skqc	åš æ„½
skqr	æ…’
skxg	æœ
skxx	æ‚½
skzx	æ…š
skzz	æ…©
sksb	å…¤ å°¡ é»‹
sksm	éŸ‘
sksz	è¼
skss	è¾‰
sksw	è€€
skrl	æ†“
skrk	æ’
skrj	æ„
skrc	æ…±
skrr	æ‚
skwj	æ‡
skyt	æ
skyj	æ€„
skyr	æ…¡
shbb	ç‹– ç±
shbm	ç‹ ç°
shbt	ç‹´
shbl	çŒ½
shbx	çŒ”
shbc	ç‹©
shbw	ç™
shpd	æ‚§
shpn	æ‚¸
shpk	çŒ¹
shph	æ„€
shmb	ç‹½
shmm	çŒ¸
shmd	ç§
shmg	çŒ¡
shmq	ç ç©
shmv	çƒ
shmw	ç€
shmy	ç¨
shfm	ç‹†
shfj	é‚«
shfq	ç‹·
shfw	ç
shfy	ç‹¬
shdm	çŒ— çˆ çœ
shdd	æŒ
shdt	æ†£
shdk	ç‹‰
shdx	ç 
shds	çŒ
shdr	ç‹®
shdv	çŒ¶ æƒ´
shdw	ç¶ ç¿
shdy	ç‡
shtf	å–¾ æ‚
shtd	çŒ¿ çŒ¥
shtq	çŒ¬
shtz	æ…¥
shts	çŸ
shty	çŒ¦
shnb	çŒ 
shnd	æ‡Š
shnl	æ†
shnx	ç‹¾
shns	ç‹™
shnr	ç‹ˆ
shnv	ç‹¦
shlp	çŒ±
shlm	çŒ›
shlf	ç
shld	çŒ´ çŒ¤
shlt	ç‹ƒ
shlh	å³±
shlj	çŠ¯ çŠ¼
shlx	ç‹² çŒ»
shlz	ç
shls	ç å¿°
shlv	ç
shlw	æ…› çŒš
shly	ç‹¡
shgb	ç· ç‹” çš
shgf	çŒ§
shgg	ç‹¼
shgq	çŒ¾ ç‹’ çŒ
shgx	çŒ• çŠ¿
shgc	çŒµ
shgr	çŒ
shgv	çŒ³
shgy	ç¼
shkb	çº
shkp	çŒ
shkd	ç‹­
shkk	æ„· ç‹Ÿ
shkh	çŒ€
shkq	ç‹¨ ç‹˜
shkx	ç‘
shkc	æ‡… çŒ¼
shkr	ç‹¹ ç­ çŠ»
shky	ç®
shhm	ç¹
shhf	ç‹§ ç›
shhd	çŒ ç‹£
shht	çŒ‡
shhl	çŠ° æ‚
shhk	æ†ˆ
shhh	æ†¦
shhz	é€– ç‹…
shhs	ç† ç‹ ç”
shhr	ç… ç‹›
shhv	ç‹Œ çŒ¯
shhw	ç• ç¥
shjp	ç‹³
shjm	ç‹°
shjd	ãº„
shjn	ç¬ ğ¬¸š
shjk	çŒƒ
shjq	ç‹± ç¡
shjx	ç‹
shjc	çŒ­
shjs	çŒŠ
shjr	çª ç«
shjv	ç‹¸ ç€
shqf	åŒ”
shqg	çŠ¹ åŒ‘ ç‹µ
shqh	çŠ½
shzm	çŒ™
shzf	ç‹¤
shzd	çŒ˜
shzl	çŠµ
shzg	ç‹¿
shzh	çŒº
shzj	ç‹
shzv	çŒ¨
shcb	ç— çŒ‰
shcd	ç
shct	çŒ«
shcj	ç¦
shcq	ç„˜
shcx	ç‚ ç‚
shcc	ç´
shcv	ç²
shcw	ç¾
shsb	ç–
shsp	æ©¥ ç‰
shsf	æ¬ ç‹œ
shsd	çŒ°
shsn	çŒŸ
shss	ç‹
shsr	çŒª ç‹¥
shsy	çµ çŒ¢
shrb	çŒ‘
shrp	çŒ“
shrf	çŒ çŠ
shrg	ç‹‘ çŒ‚
shrk	ç‹š
shrj	çŒ²
shrr	çŒ–
shrv	çŒ© çŒ
shrw	æƒ¶ æ†¿
shry	ç‹¯
shvq	çŒœ
shvx	ç‹‹
shvr	å¸® å¹š
shvw	ç“
shwf	ç‹¢
shwd	ç½
shwt	çŠº
shwn	ğ«›­
shwq	ç„ éµŸ é¸‘
shwz	é€›
shws	çŒ
shww	ç¤
shyf	ç¢
shyh	ç‹•
shyq	ç¯
shys	ç‹
shyr	ç‹¶
shyv	ç³
shyw	ç‹» çŒ£
sjmd	æ„Œ
sjmr	æ‡€
sjfr	æ†¸
sjnc	æƒ€
sjlb	æ…£
sjlr	æƒ¯
sjgg	æ€
sjkb	æ‡™
sjqd	æ„‰
sjqg	æ†±
sjqs	æ…¨
sjcn	æ‡ˆ
sjcj	æ‘
sjcw	æ†º
sjvx	æ†
sqmt	æ 
sqdp	æ„¾
sqdn	æ±
sqln	å­
sqlw	æ•™
sqkf	è€‰
sqkt	è€Š
sqkj	è€ƒ
sqjg	å¿§
sqxt	å¢¯
sqxq	æƒ°
sqcd	æ†¹
sqsr	æ†¯
sqrl	ä¹½
sqrh	ç…‘
sqrq	ç…®
sqrx	ç¿¥ æ–±
sqrs	æ®¾ è¦©
sqrv	éƒ½
sxbc	å…
sxdp	æ†Ÿ
sxdr	å…¡
sxlf	æ‚Ÿ
sxlk	æ†
sxlh	å‹€ å‹Š
sxkb	æ„©
sxhs	å…›
sxjd	æ‚µ
sxjg	æ€Ÿ
sxjr	æƒ›
sxxc	æ†³
sxxs	æ†€
sxxr	æ…´
sxcv	å…£
sxsx	å…¢
sxvm	ç£
sxvd	è£»
sxvl	æƒ„
sxvj	éŒ–
sxvx	æ…“
sxyq	å…
szbw	æ‡“
szmv	æ€
szff	æ†˜
szft	æ‡›
szfs	æ†‰
szlm	éŸ“
szlc	æ‡¤
szgv	æ„‹
szkp	æ†¡
szjg	æ‚”
szxl	æ‡š
szzl	ä¹¾
szzh	æ„®
szzq	é¶¾
szzw	é›—
szsq	æ†®
szrp	æ¦¦
szrg	å¹¹
szrx	ç¿°
szrs	æ–¡
szrv	æ…¯
szrw	æ„
szry	è’
szvd	éŸ©
szyd	æ…€
szyg	æˆŸ
scbc	æ‡
scmb	è³ æ­•
scmm	æ‡µ
scmg	æ‡œ
scmq	æ‡±
scmx	ç¿¸
scfl	æ†¾
scfw	æ‡½
scnd	æ„¥
scnr	è´²
sclw	å³
sckp	æƒµ æ½
sckg	æ…²
sckh	æ‡„
sckj	æ€ˆ
scks	å°­
sckv	æ…¬
scjf	åŒ’
sczv	é¼–
scsl	æ†½
scsj	æ„–
scsq	æ…½
scrd	æ…”
scrq	æ‡¨
scwh	æ…Œ
scwj	æ¾
scyv	æ‡‚
ssbn	æ‚–
ssbz	æ‡¥
ssml	æ‡³
ssft	æ††
ssfq	æˆƒ
ssnf	æƒ
ssgz	é¸
sskb	å·º
sskj	æ€‹
ssks	æ
sskr	æƒ½
sshk	æƒ±
sscb	æ†¤
sscr	æ„¤
ssrn	æƒ¸
ssrh	æ‡
ssvl	æƒš æ„¡
ssyn	æŸ æ‚©
srbb	æƒƒ
srpd	å‰¿
srph	å‹¦
srpv	é„›
srms	æ³°
srmv	æ…¢
srfx	æ…º
srll	æƒ—
srlg	æ€œ
srlj	æ€†
srgl	äº
srgs	æ‡ª
srkd	å¥
srkv	æš¢ æ„“
srhp	ç§¦
srhv	æƒº
srjl	æ†ƒ
srqn	é¹¡
srqq	é¶º
srxf	æ„´
srxt	è™©
srsg	æˆ¦
srsj	æ„’
srss	æ„°
srsv	æƒ•
srrb	è³«
srrl	æƒ·
srrh	å—‡
srrq	æ‡º
srrr	èµ
srry	è ¢
svdb	é 
svdr	ğ« †
svnn	ç”®
svnq	é³·
svlh	æ”°
svgl	æ€±
svgy	æ……
svqq	æ†œ
svxx	ç¿…
svxc	æ”³
svvt	æ‚­
svvv	æƒ™
svvy	æ†« æ†ª
svyh	æ¸
svyx	æ„«
swmd	æ‡· æ‡
swfd	æ‡¹
swdv	æ‡ 
swlm	æ‚™
swln	æƒ‡
swlw	æ†
swhp	æ‡
swhk	æ†»
swhx	æ‡”
swrs	æ‚´
swyf	æ‚‹
swyt	æ…‰
swyn	æ¼
sybw	æ‚›
syff	æ†
syds	æƒ¨
sydv	æ‡¦
synq	èƒ·
synw	æƒ¾
sylh	æ€®
syhn	æˆ
syqr	æ‚•
syqy	æ¡
syzm	æ‡¢
sysh	æ…Ÿ
syvt	æ…³
syys	æ…˜
rbbn	é¹
rbbq	éµ¾
rbdx	æ›¢
rbds	æ™• æ™–
rbkk	æš„
rbkz	æšˆ æš‰
rbkc	å¹
rbjj	å¸µ æ™¼
rbxq	é·ƒ
rbsl	å¹°
rbrl	æš å¹
rbvs	æ™¥
rbyx	æš¡
rpdb	é¡†
rpdr	é¢—
rpgx	æ™°
rphd	è¤
rpjg	å¤¥
rmtg	æ›
rmsr	æ›™
rmvv	é„¤
rmyw	æ›ª
rfmq	æ°€ é·œ
rfmx	å©
rfmz	é±
rfmw	æ•¸ ç”Š
rffp	å¹§
rffs	å¹ æšº
rffw	æ›®
rfzj	æš†
rfzz	æš¶
rdpm	æš½
rdmb	å¹ æšŠ
rddx	æš¸
rdgh	æ™œ
rdkk	æš›
rdrj	æ™»
rdrz	æš°
rdvj	æ™‡
rdwt	æš€
rdwq	æ›¦
rtfg	èˆ—
rtts	æ›‰
rndb	é¡’
rndr	é¢™
rntf	æ™­
rngb	æ™ª
rngx	æ™£
rnkk	å¹—
rnsh	å‹—
rnvm	å¸½
rnwk	å¸¼
rlbs	æ™”
rlmb	è²ª
rlfb	é ·
rlfr	é¢”
rlfy	æ›§
rlnq	é³¹
rlnr	è´ª
rlld	å¸¿
rllw	æ•œ é›‚
rlgb	é ˜
rlgd	æšŒ åˆ¢
rlgn	é¸°
rlgq	é´’
rlgx	ç¿
rlgr	é¢†
rlgv	é‚»
rlgw	ç“´
rlkb	æ›¨
rlkq	å¹Ÿ
rlkx	å¸¹
rlkz	å¹› æš²
rlkr	æš—
rlkv	å¹¢ æ›ˆ
rlhd	æ˜´
rljd	åˆ›
rljn	é¸§
rljg	æˆ—
rlxm	ç›¦
rlxk	é¿—
rlxr	éŸ½
rlxv	é…“
rlsm	å¹ƒ æš
rlvy	ä¾Œ
rlwd	è¡¾
rlwz	æš¹
rgms	æš´
rgmv	æš‡
rgmy	æ›¯
rgfm	èˆ’
rgfg	èˆ–
rgfq	éµ¨
rgfv	èˆ˜
rgdk	å¹ˆ
rgls	æ˜¹
rggb	æ› 
rgkt	å¹„
rgqb	æ›Š
rgzc	å¹®
rgsq	é·
rgyb	æ›‚
rkmp	æš•
rkmw	æ™¸
rkft	å¹…
rkfj	é¼Œ
rknl	æ›¬
rknj	æ—½
rknq	é´ 
rknx	é¼‚
rkgh	ç…š
rkgj	æ˜›
rkhh	æœ‚
rkhv	æœ€
rkjk	ä»º
rkjv	é‡
rkqg	æ™¡
rkcj	æš±
rksz	é€¿
rksv	æ˜œ
rksw	æ•­
rkrk	æ™…
rkrc	æš·
rkyt	æ™Š
rhmb	å¹€
rhmp	æš
rhms	æ›
rhdd	æ™ æ™€
rhdt	å¹¡
rhtm	æ›¥
rhtf	æ™§
rhnl	å¹’
rhnr	å¸§
rhgg	å¸²
rhkb	é¡•
rhkf	å¹
rhkk	æšŸ
rhkw	æ›—
rhrs	æš¤ æš­
rhrw	æ›’
rhvg	æˆ¥
rjbz	é¤«
rjbv	é¤¨
rjby	é¤½
rjpk	é¤·
rjmq	é¥–
rjmw	é¥ 
rjfb	é¥‹
rjfy	è•
rjdb	é¡¥
rjdm	é¤°
rjdf	é¥
rjdd	é¤ª
rjdt	é¥ˆ
rjdn	é¤´
rjdk	é¤…
rjdj	é¤£
rjdq	é¤»
rjdz	é¤¸
rjdr	é¢¢
rjtm	é¥
rjtd	é¤µ
rjts	é¥’
rjnd	é¥¢
rjns	é£·
rjlf	é£¼ é¤¢
rjld	é£¹ é¤±
rjlt	é¤¾
rjlz	é¤
rjly	é¤ƒ
rjgm	æ›»
rjgf	é¤¹ é¥
rjgq	é¤¶
rjgx	é£°
rjgw	é¥Š
rjkp	é¤—
rjkm	é££
rjkg	é¤”
rjkk	é¤–
rjkh	é¤Œ
rjkj	é£© é¥‡
rjkc	é¤º
rjhb	é¥¡
rjhf	é¤‚
rjhd	é¤†
rjhg	é¤ 
rjhh	é¤¤
rjhq	é¤“ é£¥
rjhx	é¤§
rjhz	é£ª
rjhw	é¤­
rjjp	é¤˜
rjjf	é¤„
rjjt	é¥
rjjj	é¤¡
rjjc	é¤¯
rjjv	é¤¿
rjqp	é¤¼
rjxd	é¤¦
rjzf	é¥
rjzk	é¥
rjzh	é£­
rjzj	é¥€
rjzx	é¤’
rjzr	é£¾
rjzv	é£µ
rjcm	é¥š
rjcf	é¤
rjcd	é¥ƒ
rjcc	é¥›
rjcv	é¥‰
rjcw	å¹¨ æ›•
rjcy	é¤€
rjsb	é¥™
rjsp	é¥“
rjst	é¥„
rjsn	é¤‘
rjsg	é¥Œ
rjss	é£½
rjsy	é¤¬
rjrb	é¤›
rjrp	é¤œ
rjrm	é¥‚
rjrj	é¤²
rjrs	æ™© é£» é¥†
rjrr	é¤©
rjrv	é¥… é¤³
rjvx	æš©
rjvv	é¤Ÿ
rjwf	é¤
rjwd	é¤ é¥Ÿ
rjwt	é£³
rjwk	é¥˜
rjyf	é£´
rjyg	é¤
rjyq	é¥‘ é¤š
rjyr	é¤™
rjyw	é¤•
rqbg	æ˜½
rqdp	æš£
rqvg	å¸—
rxmb	é£®
rxmz	æ›ƒ
rxlf	æ™¤
rxkb	å¹Š
rxkd	æ˜»
rxkh	æ˜®
rxhf	å€‰
rxhd	å‰µ
rxhg	æˆ§
rxhq	é¶¬
rxjd	å¸³
rxxq	æ¯¾
rxxz	é¢
rxxw	æ›œ
rxvx	å¹–
rzbk	æ›€
rzbv	æš§
rzbw	æ›–
rzmv	æ˜¨
rzff	æš¿
rzdb	é¡Œ
rzdr	é¢˜
rznq	é¶—
rzlm	éŸ™
rzlc	å¹¬
rzgv	æš– ã¬Š
rzjd	å¹¯
rzjg	æ™¦
rzxh	å°Ÿ
rzzh	æšš
rzsq	å¹ 
rzvd	éŸª
rcbc	å¹ª æ›š
rcmq	å¹­
rcfq	ç…§
rcdb	æ›“
rcnd	æš
rclq	æ™Ÿ æ™ 
rckp	å¹‰
rckf	æšµ
rckg	æšª
rckq	æ›£
rcks	æ›„ æ›…
rcjw	æ›”
rccn	æ›
rcsb	å¸º
rcrd	å¹™ æš¯
rcvd	æ™¨ å¸ª
rcvq	é·
rsmx	æš³
rsfn	å¹¥
rsfq	æ›­
rsng	æš”
rskk	æš…
rsks	æ™ƒ æ™„
rshc	å¸±
rsqr	æš‘ å¸¾ æš
rscb	å¹©
rscs	æš
rsrb	æ­‡
rsrn	é¹–
rsrj	æ›·
rsrq	æ¯¼ é¶¡
rsrz	é
rsrr	æš™
rsvp	æ•¡
rsvd	å‰”
rsvl	æƒ–
rsvq	é¶
rsvz	é€·
rrbx	æš¥
rrmm	æ­° ç‚
rrmv	å¹”
rrtd	å‰‰
rrtw	å¤
rrns	ä¿
rrlf	æ™—
rrlg	æ˜¤
rrgs	æ›
rrkh	è€¸
rrkq	éŸ±
rrkv	æš˜
rrhv	æš’
rrsj	å¹† æš
rrss	å¹Œ
rrsr	é¾§
rrsv	æ™¹
rrrd	æ›Ÿ
rrrs	å‚˜ æ›‘ æ›¡
rrrv	æ›
rvmb	å¹˜
rvnr	å¸»
rvhv	æ›
rvxt	ç•²
rvvp	å¹±
rvyd	åˆ½
rvyv	éƒ
rwmf	æ™·
rwfd	æ›©
rwnf	æš 
rwlw	æš¾
rwrs	æ™¬
rwyn	ç¦½
rwyr	æ™
rwyw	ã¬š
rybk	æ›Œ
rybw	æ™™
rymq	æ››
rydv	æ›˜
rylw	æ›¤
rygg	å¸´
ryks	æ™“
ryqr	æ™
ryvy	æ›‡
rywg	ç
ryyb	é¡¯ æ­
ryyq	ã¬
ryys	å¹“
vbbt	é™›
vbbr	éš
vbjy	éš—
vbvs	é™¢
vmbg	è²®
vmbh	å‹£
vmmm	éª˜
vmmh	é™Ÿ
vmmq	é¨­
vmjt	è™£
vmjn	é¹‰
vmjg	æ­¦
vmjq	éµ¡
vfmb	éš•
vfnr	é™¨
vfsb	éš¤
vfsr	ğ¬¯
vdpm	éš£
vdmg	é˜«
vdnd	é™¾
vdnv	é™‘
vdkm	éš˜ é™­
vdkt	å¢œ
vdkh	éš’
vdkj	é†
vdkz	éš§
vdkc	éšŠ
vdqg	éŸ¨
vdzj	éŸ¬
vdrm	éŸ«
vdvj	é™“
vtbt	é™¸
vtbw	é™µ
vtdb	é š
vtts	éš¢
vtkd	éšˆ
vnrh	ğªŸ
vlfc	å¤€
vlgk	éš¥
vlkb	éš´
vlkf	é™ª
vlkz	éšœ
vlkr	éšŒ
vlcv	éš¡
vgfy	èš¤
vggl	é˜¸
vkbb	ç¼¤ çº° ğ¬™‚
vkbk	çº»
vkbx	ç»¼
vkbz	ç»½
vkbc	çº·
vkbs	ğ¬˜˜ ğ¬˜«
vkbr	ç¼©
vkbv	ç»¾
vkby	éš¬
vkpp	ğ¬˜­
vkpm	ç¼ƒ
vkmd	ç¼³
vkmt	ğ¬™Š
vkmh	ç¼ˆ
vkfp	ç¼²
vkfm	é˜¿
vkfh	ç¼‰
vkfj	ç»³
vkfq	ç»¢
vkfx	å¨¿
vkfz	ç¼±
vkfr	ç¼‹
vkdb	ç»ƒ
vkdm	ç»® ç¼¢ ç»—
vkdf	ç¼® è¾”
vkdd	é™•
vkdn	ç»Š
vkdh	ç»¨ ç¼£
vkdj	ç»§ ç»” ç»»
vkdx	ç¼• ç¼­
vkds	ç¼…
vkdr	ç¼¯
vktl	ç¼Œ
vktx	ç¼§
vktw	ç»«
vknf	ç»¸ äŒ¹
vkng	çº§
vknk	ğ¬˜¡
vknj	é™‹
vknx	ç¼¨
vkns	ç»„
vkny	çº²
vklm	çº¾
vkld	ç¼‘
vklt	çº½
vkll	ğ«„·
vkls	ç»¿
vklr	ç¼”
vklw	ç»´
vkly	ç» ç¼
vkgm	çº¼
vkgq	ç»‹
vkgc	ç¼–
vkgv	ç¼ 
vkkt	ç»–
vkkn	çº¡
vkkk	ç¼°
vkkj	çº¯ é™¿
vkkq	ç»’
vkkc	ç¼š
vkkr	ç¼™
vkky	ç» 
vkhn	ç»£
vkhg	ğ¬˜©
vkhk	ç¼
vkhz	ç»° ç¼’ çº´
vkhs	çº¤ ç¼
vkhr	ç»µ é™ ç¼µ
vkhv	é™¬
vkhw	ç¼´
vkjf	ç»™
vkjj	ç»
vkjx	ç»‰
vkjc	ç¼˜
vkjs	ç¼
vkqg	ç»‚ é™ 
vkqy	çº®
vkxk	çº¢
vkxh	çº±
vkxj	çº¸
vkxx	ç¼¥
vkxs	ç¼ª
vkzf	ç»“
vkzt	å¡¦
vkzl	çº¥
vkzg	ğ«„§
vkzx	ç»¥
vkzr	ç¼¬
vkzv	ç¼“ ç»¶
vkcf	ç»
vkcd	ç»¬
vkcj	ç»
vkcq	ç¼„
vkcc	ç¼›
vkcv	ç»€
vksp	ç¼«
vksf	ç»±
vksd	ç»­
vkst	ç¼
vksk	é™˜
vksh	ç»¹
vksq	ç»¡
vksr	ç»ª ç»š ç¼—
vksv	ç»‘
vkrb	ç»²
vkrp	é™³
vkrm	ç¼Š
vkrj	éš
vkrz	ç¼‡
vkrr	çºµ é™œ
vkrv	ç¼¦
vkrw	æ•¶
vkry	ç»˜ è´
vkvd	çº¬
vkvn	ç»
vkvk	ç»
vkvj	ç¼†
vkvq	çº¿ ğ¬˜¬
vkvr	ç»©
vkvv	ç¼€
vkvy	çº­
vkwm	ç»›
vkwf	ç»œ ç»º ç¼Ÿ
vkwd	ç¼ ğ¬™‹
vkwn	ç¼¡ ğ¬˜¯
vkwz	ç¼
vkws	ç»Ÿ
vkwv	ç»ˆ
vkwy	çº¹
vkyf	ç»
vkyq	ğ«„¸
vkys	ç»•
vkyr	ğ«„¨
vkyv	ğ¦ˆ¡
vkyy	ç»·
vhfy	èšƒ
vhnd	éš©
vhnt	é™
vhnr	é™¹
vhgg	é¥—
vhgx	åš®
vhgr	éŸ¿
vhgv	é„‰
vhgy	è 
vhkg	éšµ
vhkk	éš‘
vhkv	é„Š
vhhv	é„•
vhjd	è¡¨
vhjv	éƒ·
vhsk	é™²
vhrg	é£¨
vhrw	éš
vjmr	é™¥
vjfr	éšª é™º
vjnc	é™¯
vjlt	å¢¬
vjlg	æ¯’
vjlx	çº›
vjgg	é™Š
vjqd	éšƒ
vjxl	éš
vjxk	éš‰
vjcj	é™’
vjsk	é™©
vjvx	éš›
vqbg	é™‡
vqbz	é›
vqms	æ±¬ éš
vqnq	é¶„
vqjm	é™
vqjj	é˜
vqqp	é
vqqt	å •
vqqz	éš
vqxt	å¢®
vqxk	éš“
vqxh	å¶
vqxq	éš‹
vqxz	éš¨
vqxs	éš³
vqzm	éœ
vqcv	åˆ±
vqss	é—
vxfz	èº„
vxdp	ç³ª
vxdf	ç¤•
vxnq	é·¿ é¸Š
vxnx	é¼Š
vxln	å­¹
vxkd	åˆ­
vxkh	åŠ² å·¯
vxkz	è¿³
vxkr	é¢ˆ
vxhq	éš²
vxjg	é˜º
vxrx	éš™
vxvx	ç¥˜
vxwd	è¥
vxwg	ç’§
vxyx	ç¹´
vzmv	é˜¼
vzdj	é™
vzlc	éš¯
vzxp	æªƒ æ«½
vzxl	éš± éš 
vclj	é˜¨
vcxq	éš‡
vcvd	é™™
vsft	éšš
vsfj	é¼‹
vsdb	é ‘
vsdp	é™±
vsdr	é¡½
vsnx	é»¿
vshc	é™¦
vsqr	é™¼
vszh	é™¶
vscb	éš«
vsrp	éšŸ
vsyf	å…˜
vrlg	é˜¾
vrly	é™°
vrkv	é™½
vryq	éš°
vvbx	é–±
vvpq	é·´
vvmb	é–´
vvmp	é—…
vvmd	é—¤
vvmg	é™š
vvmq	é—– é—ƒ
vvms	é––
vvmw	é—
vvfb	é— 
vvff	é—† é–­
vvfs	é—¡ é—š
vvfv	é–¼
vvfy	é–©
vvdd	é–¢
vvdj	é–¹ é—‚
vvdx	é–²
vvtm	é—”
vvtt	é–¨
vvtz	é—¥ é—§
vvty	é—
vvnb	é—•
vvnk	é–«
vvnr	è´¤
vvlm	é—ˆ
vvld	é—‹
vvlg	é–¥
vvlk	ç«– é–š
vvlr	é—‡
vvlw	é–µ é—
vvgg	é–¬
vvgs	é—€
vvgw	é—™
vvkp	é—Œ
vvkm	é–… é–œ
vvkf	é—Š
vvkn	é¸¶
vvkk	é–¸
vvkh	è é–¯
vvkq	é–¾
vvkz	é–³
vvkc	é—˜
vvks	é–›
vvhp	é—‘
vvhg	é–®
vvhk	é—“
vvhs	é—
vvjf	é–¤
vvjg	å¼
vvjj	é–»
vvjx	é—Ÿ
vvqk	é—¦
vvqh	é–•
vvqy	é–
vvxt	é—‰
vvxk	é™‰
vvxx	é—„
vvxr	é–½
vvzv	é–¿
vvst	é—› é—£
vvsr	é—
vvrg	é–
vvrq	é·¼
vvrx	é—’
vvrs	è¦¸
vvrr	é–¦ é–¶
vvry	é–º
vvvb	æ¬¼ æ­  é¡™
vvvp	æ¡‘ æ• 
vvvd	å‰Ÿ
vvvq	æ¯² éµ½
vvvx	é—¢
vvvz	é€«
vvvs	å  é–—
vvvr	é¢¡
vvvv	å• é—
vvvw	æ•ª
vvwf	é–£
vvwt	é–Œ
vvwg	é– 
vvwr	é–¡ é–™
vvwy	é–”
vvyn	é–
vvyk	é—œ
vvyq	é– é—— é·³
vvyx	ç´§
vvys	è¦µ
vwmb	è´…
vwmq	é©
vwfy	è¯
vwdv	éš®
vwnq	é·”
vwnx	é¼‡
vwnr	èµ˜
vwkh	è±
vwkv	éš†
vwky	é¿§
vwjk	é³Œ
vwjq	é°²
vwqm	é™
vwyq	ğ¬¯€
vwyr	é™”
vybw	é™–
vyby	é­‚
vydv	éš­
vylh	åŠ¨
vyxz	å‡ ç¹›
vyzv	å†
vysv	éš€
wbbp	ç›
wbbh	ç‘
wbbr	è«§ ç‘
wbfq	è†
wbds	ç²
wbtl	äº´
wbns	èª¼
wbkb	ç’Œ ç’¸
wbkm	äº­ è© è«¡
wbkk	ç‘„ è« 
wbkz	ç¿ ç’­ è«¢
wbkc	è±ª
wbhp	ç¨
wbht	è®…
wbhq	è©« äº³
wbjd	è¤¢
wbjj	ç¬
wbjy	ç‘° è¬‰
wbqb	ç‘¸
wbzz	è­º
wbvx	ç® èª´
wbvs	ç“
wbyq	æ¯«
wppz	ç’´
wmbx	ç“”
wmmd	è¤±
wmtg	è­¯
wmgf	å’
wmgr	æ˜
wmkd	ç’° è­
wmqd	è¤­
wmsr	èª»
wfmf	ç’
wfmd	è¡· è£›
wfms	æ´œ
wffb	ç“‰ è®ƒ
wffp	ç’ª è­Ÿ
wffd	è¥„
wffg	ç“¤
wffh	å‹·
wffj	è«¤
wffs	è­‚
wffr	è­›
wffw	è®
wfdb	é Ÿ
wfnq	éµ…
wflw	é›’
wfkd	èª¤
wfkh	è«¿
wfhd	è£µ
wfzz	ç’‡
wfsb	ç’
wfsz	è­´ è®‰
wdbf	è«®
wdpm	ç’˜
wdpz	è¬
wdmb	é Š é½
wdmm	é½
wdmd	åŠ‘
wdmg	ç¯
wdmk	éŸ² é½
wdmh	é½Œ
wdmx	é½‹
wdmr	ç’” è­„
wdmv	é½Š
wddx	ç’™
wdnd	ç‘Œ
wdnr	é¡¼
wdnw	ç“‡
wdgm	è©¶
wdgh	ç¶
wdkm	ç¦ è¬š
wdkd	ç‘
wdkn	è©³ çœ
wdkk	ç‘³ è«©
wdkh	è¬™
wdkx	è­¾
wdkz	ç’² è­¢
wdkc	è¬­
wdkr	è­œ
wdxc	è­
wdcd	ç¢ è«‘
wdsz	ç
wdss	ç·
wdsr	è­‡
wdrz	ç‘½
wdvm	ç©
wdvj	èª‡
wdwq	è­°
wtbd	è¤»
wtbw	è¬–
wtdb	é 
wtdr	é¢ƒ
wttt	ç“ƒ è®„
wtts	è­Š
wtlh	åŠ¥
wtlz	é‚
wtkr	ç®
wthy	è«·
wtrq	ç¾
wnmv	è©œ
wnfb	æ­Š
wnfp	æ•² æ§€ ç¨¾ é«
wnft	é«š
wnfn	é«œ
wnfl	é«›
wnfh	é«
wnfq	é¶®
wnfs	æ¯ƒ
wnfv	é„—
wndk	çš
wndj	èª·
wntf	èª¿ ç±
wnnk	çŠ
wngb	ç 
wnkx	è­
wnsg	çƒ
wnsk	è¨µ
wnrx	ç’
wnvm	ç‘
wnwd	äºµ
wlbf	è¬—
wlbr	è«¦ ğ¤§›
wlmq	çƒ¹
wlfd	è¤’
wlnf	è¬ª è¬«
wlnt	å¡¾ å¢ª
wlnn	é¹‘ æ’‰
wlnl	æ†
wlnj	éœ
wlnq	ç†Ÿ é¶‰
wlnz	ç“‹ è®
wlns	äº¸ åš²
wlnv	éƒ­
wlnw	æ•¦ å­°
wlgp	ç‘ˆ
wlgf	è­ ç’š
wlgd	è¢¤
wlgn	èª¦
wlgk	è­‰ ç’’
wlkb	ç“
wlkf	è© ç£
wlkl	è­©
wlkg	ç³
wlkq	è­˜
wlkz	ç’‹
wlks	ç’„
wlkr	è«³
wlkw	è­€
wlhf	çˆ
wlhd	ç‹ è­²
wlhh	ç•
wlzq	è«
wlcs	è«º
wlsm	è«± ç‘‹
wlrk	äº±
wlvs	ç­
wlwq	è­™ éµº
wlwz	ç’¡
wlwv	è¬¢
wgmv	ç‘•
wgdh	è­§
wgls	è© 
wggx	è¬†
wggc	è«
wgkf	è©¬
wght	è¬•
wgjv	ç‘¯
wgxb	ç“†
wgxf	ç‘­
wgcq	è¬¶
wgsf	çš
wgwy	èª¸
wgyb	ç’œ
wkmp	è«« ç‘“
wkfb	ç“
wkfp	èª
wkfm	ç‚ è¨¶ è¬Œ
wkft	è«¨
wkfj	è¬³
wkfq	ç™
wkds	è©• ç¶
wkty	çº
wknj	ç“² è¨°
wknq	èª¡
wkgj	è©
wkkp	ç’–
wkhh	è®˜
wkhr	ç‘¨
wkhv	ç‘˜ è«
wkqg	èª§
wkqw	ç’·
wkxg	è©¦
wkxz	èª±
wkzz	ç’‰ è¬°
wksk	èª™
wkrp	çœ èªº è«Œ
wkrl	ç’¤ è­“
wkrc	ç‘¼
wkwj	èª†
wkyt	èªˆ
whbm	ç’¿
whpd	ç èª—
whpn	èª˜ ç‡
whpg	è¬»
whpx	è«‰
whps	ç“ˆ
whfd	è¢ 
whfn	ç‘€
whfy	è›®
whdd	ç§ èª‚
whdt	ç’  è­’
whdv	ç‘ è«¯
whtb	è®š ç“š
whtm	ç“
whtf	èª¥
whts	ç— è©µ
whtr	ç“’
whnt	è¬›
whnl	ç’ è¬¥
whnq	ç´ èª éµ‰
whns	è¬¯
whlf	ç“— è®—
whln	å­ª
whlq	ç“› è®
whlw	ç’€
whkf	ç’
whkc	ç’© è­µ
whhp	ç¨Ÿ
whhn	è¬¼
whhk	è­ƒ
whhh	çˆ•
whhv	ç‡®
whhw	å¤‘
whjp	ç’¨
whjf	è£”
whjd	è¡£ å“€
whqc	è¬
whzg	ç½ èª”
whsf	è©±
whsk	è«ˆ
whrb	é¡«
whrp	ç“… çš½
whrf	ç¢§
whrn	é¹¯
whrl	çŒ
whrk	äº¶
whrh	å‹¯
whrq	æ°ˆ é¸‡
whrz	é‚…
whrs	ç‘”
whrr	é¢¤
whrw	ç‘ ç’¬ è«» è­¤
whvx	ç¦€
whvr	ç‘¡
wjmd	ç‘
wjmr	ç’¯ è­®
wjmv	è¬
wjft	è®’
wjfc	è®‘
wjfr	è­£
wjfy	è±
wjts	äº¹
wjnc	è«–
wjnw	ç“Š è®‚
wjlb	ç‘» ç’ è¬´
wjlc	ç‘‘
wjgp	æ¤‰ è¬‹
wjgf	è©º
wjgd	è¢²
wjgg	èªƒ
wjkb	ç’µ
wjks	ç‘–
wjhm	è¡
wjhd	è£’
wjqd	ç‘œ è«­
wjxm	è« ç¤
wjxs	è­­
wjcj	è©­
wjcw	è­«
wjsj	æ°“
wjry	æœš
wjvd	è£
wjvh	è¬  ç‘¤
wjyw	æœ›
wqbg	ç‘
wqmd	è¡º
wqmn	ç”
wqmh	è¨ ç¡
wqmz	é€„
wqmv	çŠ
wqjg	è¨§
wqcd	è­¨
wqsr	è­–
wqvg	è©™
wxbv	èª›
wxmm	ç’›
wxmt	ç’¢
wxfd	è¥ƒ
wxfk	è®
wxlf	èª ç¸
wxld	è£¦
wxhf	çº
wxhd	è¤
wxjg	è©†
wxjr	ç˜ è«™
wxxc	ç’•
wxxs	è¬¬ ç’† ç’»
wxxr	è¬µ
wxsm	ç’¶
wxrk	èª£
wxvx	è¬¤
wxyd	è¤
wzbs	èª­
wzbv	ç‘·
wzbw	ç’¦
wzmb	è®€ ç’³ ç“„
wzmv	è©
wzmw	è®Ÿ
wzff	è­†
wzln	çˆ
wzlg	èª•
wzlq	ç“™
wzlz	ç
wzlc	ç’¹ è­¸
wzgv	ç‘— è«¼
wzhq	è­Œ
wzjf	è­—
wzjg	èª¨ ç»
wzzh	è¬¡ ç‘¶
wzsq	ç’‘ è­•
wzyd	è¬‘
wcfq	ç‘Š è«´
wcfw	ç“˜ è®™
wctm	ç“‚
wcty	è®›
wcnd	ç‘›
wclb	èª®
wclq	èª  ç¹
wclr	è†¥
wclv	è­· ç“
wckp	è«œ
wckg	ç’Š
wckj	ç´ è©
wckq	è®Œ
wcks	è­ ç’
wckr	ğ«©
wckv	è¬¹ ç‘¾
wchm	ç“‘ è®ˆ
wchn	ç’“
wchx	è¬œ
wcjp	ç‘¹
wcjv	ç”…
wcjw	ç’¥
wcqf	è«¾
wcsb	çª è«†
wcst	ç’‚
wcsj	è«¶
wcrd	è¬¨
wcrj	è­ª
wcvp	è¬€
wcvd	èª«
wcwh	è¬Š
wsbn	èª–
wsmb	ç‘£
wsml	è­¿
wsmz	é€¢
wsmy	è ­
wsft	ç’« è­¡
wsfq	è®œ
wsfr	ç‘º
wsfy	ç‘š
wsdp	è«Š
wsng	è«µ
wsnh	è¬…
wsnq	ğ¤©½
wsnr	ç
wskj	ç‰
wsks	ç–
wskr	ç‘‰
wshk	ç‘™
wshw	èª‘
wsqn	èªŸ
wsqr	è«¸ ç½
wsxv	ç¡ è«”
wszy	è¬¿
wssd	è¢Œ
wssg	è­”
wsrp	ç‘§ ç’…
wsrn	ç«
wsrr	ç‘ƒ
wsyn	è©¾
wrbb	ç¨
wrpd	è£¹
wrmv	è¬¾
wrfx	è¬±
wrlf	ç€ èª
wrll	è«—
wrlg	ç² è©…
wrlj	ç±
wrkv	ç‘’ è«¹
wrhd	è¡°
wrhv	ç‘† è¬ƒ
wrjh	è©¤
wrxf	ç‘² è¬’
wrsj	è¬
wrrb	é¡‡
wrrm	è­…
wrrq	è®–
wrrs	å’
wrrw	é›œ
wrwy	ç
wvmb	è¬®
wvmg	ç·
wvfy	è½
wvgy	ç‘µ
wvhd	è«˜
wvht	å£…
wvhg	é¥”
wvhh	ç½‹
wvhw	é› ç”•
wvjg	ç‘‡
wvqz	ç ç“
wvzl	è®”
wvvp	ç““ è®•
wvvf	é«™
wvvj	è®‡
wvvv	è«
wvvy	è­‹
wwbb	çµ
wwbm	è«ª
wwbc	è­¹
wwmd	ç“Œ
wwmj	ç¶
wwfd	è®“ ç“–
wwdv	ç’¾
wwnf	è¬
wwln	è«„
wwlw	è­ˆ
wwhk	ç’® è­ 
wwhv	ğ¤«‰
wwcp	æ–„
wwcn	çŠ› å­·
wwcq	æ°‚
wwcx	å« 
wwcc	å‰º
wwcs	æ¼¦
wwcv	é‡
wwsm	ç’
wwrl	ç´
wwrs	ç— èª¶
wwwb	ç’±
wwyn	ç’ƒ è¬§
wwyh	ç‰
wwys	ç« ç³
wwyr	è©²
wwyw	æ–‘
wybn	ç‰½
wybw	èªœ
wymf	è´ é©˜
wymg	å¤£
wyms	æ–
wyff	è ƒ è­‘
wyfd	è¢¬
wyfr	æ–” è¤
wyfy	èš‰ è¡
wydf	ç¾¸
wydv	æ–‹ ç“€ è­³
wytv	é„
wynf	èµ¢ é¸
wynn	ç¦»
wynq	é³¼ é´
wynw	é›¢
wyln	æ–ˆ
wylh	è©
wygp	æ–“
wygg	æ– ç– è«“
wygc	æ–’
wykh	æ–Š
wyjs	æ––
wyqd	å‰‚ å‰¤
wyqk	é½‘
wyqq	èªµ
wyqx	æ–
wyqz	é€³
wyqr	ç‹
wyqv	æ–‰
wyxf	å¬´
wyxh	ç…
wyzm	ç’¼
wyzd	çˆ èª’
wycb	é¡
wycs	å½¥
wycv	ç”¢
wycw	æ£„
wysp	æ¬’
wysm	çŸ•
wysd	å¥±
wysn	æ”£ å­¿
wysl	æˆ€
wysg	å½
wysh	å·’
wysj	é‘¾
wysq	é¸
wysx	å­Œ
wyss	ç‡ å› ç“ é¾»
wysr	æ›« è‡ 
wysv	è«¥
wysw	è®Š
wysy	è »
wyrb	æ¬¬ è³Œ é ¦
wyrf	è‡
wyrd	åˆ»
wyrh	åŠ¾
wyrr	é¢
wyrv	éƒ‚
wyvb	è´‡
wyvp	æ–•
wyvg	æ–Œ
wyvj	ã»¬ è¬£ ğ¨­‰
wyvr	èµŸ
wywy	ç†
wyyq	è­ ç’£
wyyx	ç´Š
wyys	è¬²
ybbt	è†£
ybbk	è…”
yblq	é
ybkb	è‡
ybkt	è…Ÿ
ybkj	è‚¹
ybkz	è…ª
ybkc	éœ¥
ybhd	è„“
ybjj	è…•
ybqb	è†‘
ybcg	è‡—
ybvx	è…™
ybvs	è„˜
ybwb	éŒ
ybwp	çš´
ybwq	éµ•
ybwz	é€¡
ypps	éœ¦
ypmn	é¹´
ypmq	é¸˜
ypgd	å‰
ypgg	å¼’
ypkg	å¼‘
yprs	è†
ypvr	é–·
ymmw	è‡
ymth	å‹³
ymtq	ç†
ymjy	èœ°
ymsk	éŠ
ymsy	è‡…
yfmb	è´’ éœ£
yfmf	éœ²
yffb	é¾—
yffp	è‡Š
yfff	éœ
yffk	éˆ
yffj	è…­
yffx	å­
yffv	é…ƒ
yfnp	æ•½
yfnf	å–¬
yfnh	å‹ª
yfnq	é·®
yfnw	æ•¿
yfkd	è„µ
yfkq	éœµ
yfsb	è†­
ydpm	è†¦
ydpx	ğ¦¼
ydmb	è²µ é ” é £
ydmf	è„´
ydmg	è‚§
ydmk	èƒš
ydfb	è³¸
ydfp	æ¦º
ydfm	è…¾ è†¡
ydft	å¡
ydfk	ä²¢
ydfh	å‹
ydfj	è…ƒ
ydfq	é¨° é°§ é»±
ydfx	åªµ ç¸¢
ydfs	æ»•
ydfr	å¹
ydfw	è¬„
ydfy	è£
yddx	è†«
ydnb	é¡¬
ydnd	è…
ydns	è…¼
ydnr	é¢¥ ğ¬±–
ydnv	éœ€ èƒ¹
ydgh	ä²
ydkm	è†‰
ydkf	è†³
ydkd	æœ•
ydkn	ç¾˜
ydkh	è†
ydkz	è»¬
ydhw	éœº
ydsq	æ¯µ
ydrj	è…Œ å¥™
ydvm	èƒ»
ydvj	èƒ¯
ydvq	éµ©
ytdm	ç›­
yttt	é
ytts	è†®
ytkd	è…²
ytky	é¿¨
ytyd	è„š
ytyt	é
yndk	èƒ­
yntf	éœŒ
ynnq	é´˜
yngb	è…†
ynkk	è†•
ynhk	äƒ
ynsg	è„™
ynrm	è†ƒ
ynwk	è…˜
ylbf	è†€ è†ª
ylbr	è…£
ylgp	è…¬
ylgm	éœ¿
ylgf	éœ±
ylgk	è†¯ éœ¯
ylgh	éœ§
ylgc	é›º
ylgw	éœš
ylkb	æœ§ é‡
ylkl	è‡† éœ 
ylkq	è†±
ylkx	éœ
ylkr	è…¤
ylkv	æœ£ è†§
ylhn	å­§
ylhh	è„‡
ylhq	é´¢
ylhv	èƒ
ylwn	è‡‡
ylwq	è†² é é¸–
ylww	éƒ
ygpd	å‰°
ygms	è„²
ygmv	éœ è…µ
ygfz	è†¼
ygfy	è†™
ygdh	è‡
ygld	è„ˆ
yglc	è…‘
ygls	è„‰
yggg	éœ›
ygkt	è…›
ygqw	éœ°
ygxf	è†…
ygsm	è…¯
ygsf	è…’
ygvc	éœ¨
ygym	ç›
ygyd	å‰—
ygyt	è™¦
ygyg	æˆ”
ykbs	éœƒ
ykfp	è„¨
ykfm	èƒ¢
ykft	è…·
ykfk	è„°
ykfj	è†’
ykds	èƒ“
yknj	è‚«
yklf	éœ¶
yklg	è„¦
ykgr	èƒ°
ykgy	éœ
ykkk	éœŠ
ykkr	éœˆ
ykhf	éœ‘
ykqg	è„¯
ykqc	è†Š
ykxx	éœ‹
ykxz	è„»
ykzz	éœª
ykcm	é‹
ykcj	éœ®
ykcz	é¯
yksk	è„›
yksx	ç¿˜
ykrp	è…–
ykrg	è„¼ éœ—
ykrc	è†
ykrr	è„¥
ykvg	è…» è†©
ykwt	éœ”
ykyt	èƒµ
yhpd	è„·
yhpx	è…‡
yhdd	æœ“ è„ é›¿
yhdt	è†°
yhdn	é›½
yhdv	è…¨
yhtb	è‡¢
yhtm	è‡š
yhtr	è‡œ
yhnb	è†
yhnh	åŠº
yhnq	é´¾
yhlw	è†—
yhgg	è…
yhkc	è‡„
yhhh	æœ¥
yhjh	èƒ
yhzg	éœ† è„¡
yhsk	è…„
yhrs	è…º
yhvz	è†‡
yjmj	è„ƒ
yjmr	è†¾
yjmv	è†„
yjfr	è‡‰
yjnq	é
yjnc	è…€
yjlg	èƒŸ
yjlc	è…
yjks	è…¶
yjqd	è…§
yjcj	è„†
yjcw	è†½
yjsk	è„¸
yjrj	éœ­
yqbb	èƒ½
yqbl	æ…‹
yqbg	èƒ§
yqbh	ç†‹
yqbq	ç†Š
yqby	èš
yqms	è¦’
yqdp	æ¯©
yqdr	æ°†
yqtl	æ¯¸
yqnb	é¬¯
yqng	æ¯¬
yqlf	æ¯°
yqlw	æ•
yqkk	éœ»
yqkq	æ¯§
yqhf	æ¯¡
yqhh	æ¯¯
yqhs	æ¯¨
yqjd	æ¯º
yqjg	è‚¬
yqjr	æ°‡ æ°Œ
yqqs	æ®½
yqqv	éƒ©
yqxg	æ¯½
yqxz	è†¸
yqcd	è†¿ æ°
yqsp	æ¯±
yqsr	æ¯¥
yqrb	æ¬·
yqrq	éµ—
yqrv	éƒ—
yqrw	ç“»
yqvg	èƒˆ
yqwk	æ°Š
yqyn	æ¯ª
yqyq	æ¯³
yqys	æ¯¶
yqyv	éƒ„
yxng	è…±
yxjd	è„¹
yxjg	èƒ
yxxs	è†  è‡
yxxr	éœ«
yxvx	è†˜
yzmn	æ“¥
yzmj	é‘’
yzms	è¦½ è¦§
yzmv	èƒ™
yzmw	è­¼
yzff	è‡¨
yzfs	è†¨
yzfv	è‡Œ
yzdb	æ¬¸
yzdj	èƒ£
yzdz	é€˜
yzln	è„¬
yzlg	è„ 
yzhm	é¹½
yzjg	éœ‰ è„¢
yzcv	éœ¾
yzsm	ç›¬
yzsq	è†´
yzrv	è†“
yzrw	è…¹
yzyd	è†
ycbc	æœ¦ é€
ycnd	æœ  éœ™
yclh	é›³
yclv	è‡’
yckj	æœ‘
yckq	è‡™
ychm	é‚
yccq	è‡Ÿ è‡“
ycrd	è†œ
ycrj	è‡ˆ
ycvp	è…œ
ycvd	éœ‡ è„¤
ycws	è†µ
ysbb	ç¹½ ç´• ç¸¯
ysbm	ç´µ
ysbf	ç¸–
ysbn	è„–
ysbl	ç·
ysbk	ç¸‡
ysbj	ç¶©
ysbx	ç¶œ ç¸¡
ysbz	ç¶» ç··
ysbc	ç´›
ysbs	ç´ ç¶„
ysbr	ç¸®
ysbv	ç¶°
ysby	ç¶‹
yspp	ç¶
yspm	ç·—
yspg	çµ‰
ysmb	ç´ª
ysmd	ç¹‰ ç¹¯
ysmt	çº†
ysmg	ç¹¹
ysmh	ç·²
ysmj	ç´¦
ysmx	çº“
ysms	çµ¸
ysmw	çº™
ysfb	ç¸œ ç¹¢ çº‰
ysfp	ç¹°
ysff	çµ½
ysft	è†›
ysfh	ç·
ysfq	çµ¹ é¶­
ysfz	ç¸¼ ç¹¾
ysfs	ç¹Ÿ
ysdb	çµ˜
ysdm	ç¶º ç¸Š çµ çµ’ ç¹—
ysdf	ç¹•
ysdd	ç·›
ysdn	çµ† çµ´
ysdl	ç¸‚
ysdg	ç´‘
ysdk	çµ£ ç¸’
ysdh	ç¸‘ ç¶ˆ
ysdj	çµ ç¶™ ç¶£
ysdx	ç¹š ç¶
ysdz	ç¸± ç¸¦ ç¸° ç¹¸
ysdc	ç¹œ
ysds	ç·¬
ysdr	çµ” ç¹’
ysdv	ç·§
ysdw	çº‹
ystt	çµ“
ystn	ç¶¥
ystl	ç·¦
ystg	ç·ˆ
ystq	ç·­ ç¹Š çº
ystx	ç¸² çº
ystz	ç¹¨
ysts	ç¹
ystw	ç¶¾
ysty	ç´¶
ysnm	ç¸•
ysnf	ç¶¢ çµ… ç¶—
ysnd	ç´»
ysng	ç´š è…© çµ¿
ysnk	ç¶‘ çµª
ysnh	ç¶±
ysnj	ç¶²
ysnx	ç¹©
ysnz	ç¸Œ
ysns	çµ„
ysny	è‡˜
yslb	çº
yslp	ç·¥
yslm	ç·¯ ç´“
yslf	ç¸ ç¹˜ çº€
ysld	ç·±
yslt	ç´ ç¸§
ysll	ç¹¶
yslh	ç³¼
yslq	ç¹” çµ¥ ç¸ƒ
yslz	çµ
yslc	ç´¨ ç¸
ysls	ç·‘
yslr	ç· 
yslw	ç¶­
ysly	çµ ç·¶
ysgb	çºŠ
ysgm	ç´–
ysgf	ç·º
ysgt	çº
ysgq	ç´¼ ç¶Ÿ ç¸
ysgx	ç´¤
ysgc	ç·¨
ysgv	ç¸€
ysgw	ç¹–
ysgy	ç´­ çµ‹ ç¹ˆ ç¹¦
yskp	ç·´ ç¶€
yskm	ç³½
yskf	è½¡
yskt	çµ°
yskn	ç´†
yskl	ç¹ çºš
yskg	ç·‰
yskk	ç¶“ çµ™ ç¹®
yskj	ç´”
yskq	çµ¨ ç·
yskx	ç·€
yskz	ç· ç¸º
yskc	ç¸› ç¸³
ysks	èƒ±
yskr	ç¶Š ç¸‰
yskv	ç·…
yskw	ç·»
ysky	ç¶†
yshb	ç·½ çº˜
yshp	çº…
yshm	çº‘
yshf	ç´© çµ¬ çº—
yshd	çµ©
ysht	ç¹™
yshn	ç¶‰
yshl	ç¸½
yshg	ç¶
yshk	è…¦ ç¶
yshh	ç·‚
yshx	ç·Œ
yshz	ç¶½ ç´ ç¸‹
yshs	ç·š ç´£
yshr	ç¶¿ çµˆ
yshw	ç¹€ ç¹Œ ç¹³
yshy	ç¹ƒ
ysjf	çµ¦
ysjd	ç·°
ysjt	çº”
ysjn	ç¹²
ysjj	çµ¶
ysjq	ç¹ ç¹º
ysjx	ç¸©
ysjc	ç·£ ç¶¸
ysjs	ç¶  ç·
ysjr	ç¹ª
ysqd	ç¹·
ysqg	ç´Œ ç´±
ysqq	çµ 
ysqy	ç´˜
ysxb	ç¹
ysxm	ç¹¡
ysxt	ç·¸
ysxk	ç´… çµš ç¹£
ysxh	ç´—
ysxj	ç´™
ysxx	ç¸¹
ysxs	ç¹†
ysxr	ç·
ysxv	ç¶… ç¶‡
yszb	çºŒ çºˆ
yszp	ç¶µ
yszf	çµ ç¹¥
yszd	ç¸˜
yszn	ç¶’
yszl	ç´‡ ç¶•
yszg	ç¶–
yszj	çµ ç¸š
yszx	ç¶
yszc	çµ¼
yszs	ç¶š
yszv	ç·© ç¶¬
yszw	ç·®
yscb	ç¶¨ è†¹
yscp	ç·¤
yscf	ç´¹
yscd	ç·“ ç¸¸
ysct	ç·¢ çº’
yscl	ç¹±
ysch	ç¸™
yscj	çµ• ç´²
yscq	ç·˜ çµ¾ ç¸… ç¸¬
yscx	ç¸“
yscz	çº„
yscc	ç¸Ÿ
yscv	ç´º ç·¾
yssp	ç¹… ç¸¥
yssf	ç·”
yssd	è¤œ
ysst	ç·‡
yssn	ç¶
yssl	ç·«
yssg	ç·– ç¹
yssk	ç·ª ç¸†
yssh	ç¶¯ ç¸ ç¹¬
yssq	ç¶ƒ
ysss	çµ–
yssr	ç·’ çµ¢ ç·¡
yssv	ç¶
ysrb	ç·„
ysrp	ç¶¶
ysrm	ç·¼
ysrd	è… 
ysrl	ç´Ÿ ç¶›
ysrg	ç´·
ysrj	ç¸„
ysrq	çº– ç´’ çµ è†Œ
ysrx	ç¸·
ysrz	ç·ƒ ç·¹
ysrs	ç´¾ ç¸¨ ç¸ª
ysrv	ç·† ç¸µ ç¹“
ysry	çµµ
ysvb	ç¸¾
ysvp	ç¸”
ysvf	è„—
ysvt	çµŒ
ysvl	æ†…
ysvg	ç´
ysvh	å‹•
ysvq	å‹² ç¶ª
ysvx	ç¸¤
ysvs	ç´
ysvr	æ¿Œ
ysvv	ç¶´
ysvy	ç´œ ç¹
yswm	çµ³ ç¶˜
yswf	çµ¡ ç¶¹ ç¸
yswd	ç¸— çº•
yswt	ç´¸
yswn	ç¶§ ç¸­ ç¸´
yswl	çº
yswk	ç¹µ
yswx	ç¶‚
yswz	ç¸«
ysws	çµ± ç¶· ç¹‚
yswr	çµ¯
yswv	çµ‚ ç·• çºƒ
yswy	ç´‹ çµƒ
ysym	ç¹¿
ysyf	ç´¿ ç¹‘
ysyn	èƒ¸ è„³
ysyl	ç·¿
ysyg	ç¶«
ysyj	ç¹¼
ysyq	é·¥ çº
ysyx	çµ²
ysys	çºœ ç¸¿
ysyr	çµº
ysyv	ç·Ÿ ç¹»
ysyw	ç·µ
ysyy	ç¶³ ç¹§
yrfx	è†¢
yrll	è…
yrlg	é›¶ æœ
yrkv	è…¸
yrhv	è…¥
yrrt	è„
yrrv	éœ·
yrvy	è„
yvmb	è³¢
yvfy	èœ¸
yvdf	ç¡»
yvln	å­¯
yvlk	ç«ª
yvkk	è±
yvhd	è„¿
yvhv	è†·
yvjg	ä
yvjv	é„ 
yvxk	èƒ«
yvvv	è…
yvvw	è†¶
yvwv	éœ³
yvyb	é…
yvyp	éœ¼
yvyl	éœ’
yvyj	éœ•
yvyx	ç·Š è††
yvyz	é†
yvys	éœ´
yvyw	é‰
ywdv	è‡ éœ½
ywlm	è„
ywln	æœœ
ywlh	é›¾
ywlv	éœ©
ywlw	è…‹
ywhk	è†»
ywqm	èƒ®
ywsz	è†–
ywrj	é„
ywrs	è„º
ywvw	è‡ƒ
ywyn	è„‘
ywyq	è„ éœ
ywys	è†Ÿ
ywyr	èƒ²
yybs	æ–š
yybw	æœ˜ è„§
yymq	è‡
yydq	è‡©
yydv	è‡‘
yynq	éµ¬
yyns	çˆ¼
yynw	æœ¡
yylw	è‡›
yygd	éœ¢
yygs	éœ¡
yykq	å¹¾ ç•¿
yykx	æ–·
yyky	è ¿
yyqq	è†¬
yyqr	è„ª
yysv	è…«
yyvb	è‡”
yyyd	å‰¼
yyyt	å’
yyyq	æ¯¿
yyyx	çµ«
yyyz	éª
yyys	åƒ å„ å…
yyyv	äº
yyyy	æœ¤
